A_R_V_I	a E r v' e: I
Achemos	a x' E m o: s
Adjutor	a d' j U t O r
Adomaitis	a d o: m aI t' I s
Adomas	a d o: m a s
Afganistane	a f g a n' I s t a n' E
Afganistane	a f g a n' I s t A: n' E
Afrikos	A: f' r' I k o: s
Agaras	a g A: r a s
Airv	A: I r' v' e:
Akmenės	a k m' {: n' e: s
Akstinas	A: k s' t' I n a s
Akvilė	a k v' I l' e:
Albertas	a l' b' E r t a s
Albertina	a l' b' E r' t' I n a
Albertina	a l' b' E r' t' I n a
Aldona	a 5 d o: n a
Alegreta	a l' E g r' E t a
Alegreta	a l' E g r' E t a
Aleksandravičiūtė	a l' E k s a n d r a v' I tS' u: t' e:
Algirdas	a l' g' I r d a s
Algis	a l' g' I s
Alma	a 5 m a
Almas	a 5 m a s
Almatoje	a 5 m a t o: j E
Altaravičiūtė	a 5 t a r a v' I tS' u: t' e:
Alvaras	a 5 v A: r a s
Ambraška	a m b r a S k a
Ambraška	a m b r A: S k a
Ana	a n a
Ana	A: n a
Andrioniškis	a n' d' r' o: n' I S' k' I s
Angelė	a n' g' E l' e:
Antanas	a n t A: n a s
Antanina	a n t a n' I n a
Antanina	a n t a n' I n a
Antašava	a n t a S a v a
Antašava	a n t a S A: v a
Anzelmas	a n' z' E 5 m a s
Ančlaukys	a n tS 5 aU k' i: s
Arijus	A: r' I j U s
Ariogala	a r' o: g a 5 a
Armėnija	a r' m' e: n' I j a
Arūnas	a r u: n a s
Asta	a s t a
Asta	A: s t a
Atig	A: t' I k
Atlanta	a t 5 a n t a
Audronė	aU d r o: n' e:
Auksė	aU k s' e:
Aukštadvaris	aU k S t A: d v a r' I s
Aukštaitijos	aU k S t aI t' I j o: s
Aura	aU r a
Austriją	aU s' t' r' I j A:
Aušra	aU S r a
Aušra	aU S r a
Avitelos	a v' I t' E 5 o: s
Aviva	a v' I v a
Azerbaidžane	a z' E r b aI dZ a n' E
Azerbaidžane	a z' E r b aI dZ A: n' E
Babtai	b A: p t aI
Bachmano	b a x m a n o:
Bagušienė	b a g U S' Ie n' e:
Bagušienė	b a g U S' Ie n' e:
Bajarinos	b a j a r' I n o: s
Balninkai	b a l' n' I n k aI
Balovniova	b a 5 O v' n' O v a
Baltarusiją	b a 5 t a r U s' I j A:
Baltupiai	b a 5 t U p' aI
Baltupiai	b a 5 t U p' aI
Baltutis	b a 5 t U t' I s
Baltušnikas	b a 5 t U S' n' I k a s
Baltušninkas	b a 5 t U S' n' I n k a s
Balčius	b a l' tS' U s
Balčius	b a l' tS' U s
Bandužiai	b a n d U Z' aI
Banga	b a n g a
Banga	b a n g a
Banienė	b a n' Ie n' e:
Bartininkai	b a r' t' I n' I n k aI
Bartininkai	b a r' t' I n' I n k aI
Bartulienė	b a r t U l' Ie n' e:
Bartulienė	b a r t U l' Ie n' e:
Beganska	b' E g a n s k a
Belgijos	b' E l' g' I j o: s
Benu	b' E n U
Bernotienė	b' E r n o: t' Ie n' e:
Betygala	b' E t' i: g a 5 a
Bikuvos	b' I k U v o: s
Biovela	b' I j O v' E 5 a
Birštonas	b' I r S t o: n a s
Bojarninos	b O j a r' n' I n o: s
Bostonas	b O s t O n a s
Brazilijoje	b r a z' I l' I j o: j E
Brigita	b' r' I g' I t a
Brigita	b' r' I g' I t a
Britanija	b' r' I t A: n' I j a
Briuselį	b' r' U s' E l' i:
Bronelė	b r o: n' {: l' e:
Bronė	b r O n' e:
Bukareštas	b U k a r' E S t a s
Burbulienė	b U r b U l' Ie n' e:
Burbulienė	b U r b U l' Ie n' e:
Butkus	b U t k U s
Butkus	b U t k U s
C_V	ts' e: v' e:
C_V	ts' i: v' i:
Cecilija	ts' E ts' I l' I j a
Citma	ts' I t m a
Citma	ts' I t m a
D_N_B	d' e: E n' b' e:
D_N_B	d' i: E n' b' i:
Dagys	d a g' i: s
Daina	d aI n a
Daina	d aI n a
Dainora	d aI n o: r a
Dainutė	d aI n U t' e:
Daisena	d aI s' E n a
Daiva	d aI v a
Dalė	d A: l' e:
Danieliaus	d a n' Ie l' aU s
Danielius	d a n' Ie l' U s
Danielius	d a n' Ie l' U s
Danutė	d a n U t' e:
Darius	d A: r' U s
Darius	d a r' U s
Daugailiai	d aU g aI l' aI
Daukantas	d aU k a n t a s
Daukša	d aU k S a
Daukša	d aU k S a
Daukšiai	d aU k S' aI
Debeikiai	d' E b' EI k' aI
Deimantas	d' EI m a n t a s
Deividas	d' EI v' I d a s
Delis	d' E l' I s
Delkintienė	d' E l' k' I n' t' Ie n' e:
Dianos	d' I j A: n o: s
Didždvario	d' I dZ d v a r' o:
Didžiajai	d' I dZ' a j aI
Didžiasalio	d' I dZ' A: s a l' o:
Didžiasalio	d' I dZ' a s a l' o:
Didžiosios	d' I dZ' o: s' o: s
Didžiosios	d' I dZ' o: s' o: s
Dievas	d' Ie v a s
Dimitrijus	d' I m' I t' r' I j U s
Dobilienė	d o: b' I l' Ie n' e:
Dobilienė	d o: b' I l' Ie n' e:
Donaldas	d O n a 5 d a s
Donaldas	d O n a 5 d a s
Donata	d O n a t a
Donata	d O n A: t a
Donelaitis	d o: n' E 5 aI t' I s
Dotnuvos	d o: t n U v o: s
Dovilai	d o: v' I 5 aI
Dringelienė	d' r' I n' g' E l' Ie n' e:
Dumčius	d U m' tS' U s
Dundulienė	d U n d U l' Ie n' e:
Dundulienė	d U n d U l' Ie n' e:
Dzeusą	dz' EU s A:
Dzigaro	dz' I g a r o:
Dzingsi	dz' I n' k s' I
Dzūkija	dz u: k' I j a
Dzūkija	dz u: k' I j a
Dūkštas	d u: k S t a s
Džatra	dZ A: t r a
Džojos	dZ O j o: s
Editos	E d' I t o: s
Edmundas	E d m U n d a s
Egidija	E g' I d' I j a
Eglė	{: g l' e:
Eglę	{: g l' {:
Eidrigevičius	EI d' r' I g' {: v' I tS' U s
Eifelio	EI f' E l' o:
Eiginta	EI g' I n t a
Eiginta	EI g' I n t a
Eiginta	EI g' I n t a
Eksmos	E k s m o: s
Ele	E l' E
Elektikos	E l' E k t' I k o: s
Elektrobalt	E l' E k t r O b a 5 t
Elektrum	E l' E k t r U m
Elga	E 5 g a
Elga	E 5 g a
Elmoris	E 5 m o: r' I s
Elvinas	E l' v' I n a s
Elvyra	E l' v' i: r a
Elvyra	E l' v' i: r a
Ernesta	E r' n' E s t a
Ernesta	E r' n' E s t a
Ernestas	E r' n' E s t a s
Eugenijus	EU g' E n' I j U s
Europinė	EU r O p' I n' e:
Europinė	EU r O p' I n' e:
Eurovizija	EU r O v' I z' I j a
Ežerėlis	E Z' E r' e: l' I s
Federavičius	f' E d' E r A: v' I tS' U s
Feliksas	f' E l' I k s a s
Filomena	f' I 5 O m' E n a
Filomena	f' I 5 O m' E n a
Filora	f' I 5 O r a
Frankfurtas	f r a n k f U r t a s
Freda	f' r' E d a
Freda	f' r' E d a
Gabrielė	g a b' r' Ie l' e:
Gadūnava	g a d u: n A: v a
Gaidamavičiūtė	g aI d a m a v' I tS' u: t' e:
Galerija	g a l' E r' I j a
Gardamas	g a r d A: m a s
Gariūnai	g a r' u: n aI
Gavelis	g a v' {: l' I s
Gedvilas	g' {: d' v' I 5 a s
Gedvilas	g' E d' v' I 5 a s
Genadijus	g' E n A: d' I j U s
Genutė	g' E n U t' e:
Georgijus	g' E O r' g' I j U s
Gerda	g' E r d a
Giedrius	g' Ie d' r' U s
Giedrės	g' Ie d' r' e: s
Gintaras	g' I n t a r a s
Gintaras	g' I n t a r a s
Gintautas	g' I n t aU t a s
Girdvainis	g' I r d v aI n' I s
Girdzijauskas	g' I r' dz' I j aU s k a s
Graikijoje	g r aI k' I j o: j E
Graikijos	g r aI k' I j o: s
Greta	g r' E t a
Greta	g r' E t a
Grigaitienė	g r' I g aI t' Ie n' e:
Grigiškės	g r' I g' I S' k' e: s
Grubuvienė	g r U b U v' Ie n' e:
Gruzdžiai	g r U Z' dZ' aI
Grybauskaitė	g r' i: b aU s k aI t' e:
Grybauskaitė	g r' i: b aU s k aI t' e:
Gubernija	g U b' E r' n' I j a
Gvatemaloje	g v a t' E m A: 5 o: j E
Gytis	g' i: t' I s
Haga	G a g a
Haga	G A: g a
Henrikas	G' E n' r' I k a s
Honkongas	G O n k O n g a s
Ibisa	I b' I s a
Ibisa	I b' I z a
Ignas	I g n a s
Imperijos	I m' p' E r' I j o: s
Indonezijos	I n d O n' E z' I j o: s
Indrė	I n' d' r' e:
Ineta	I n' E t a
Ineta	I n' E t a
Ingrida	I n' g r' I d a
Ingrida	I n' g r' I d a
Irena	I r' E n a
Irena	I r' E n a
Irkutskas	I r k U t s k a s
Irma	I r m a
Islandiją	I s 5 a n' d' I j A:
Ispanijos	I s p A: n' I j o: s
Italijoj	I t A: l' I j O j
Italijos	I t A: l' I j o: s
JAV	j A: v
Jadvyga	j a d' v' i: g a
Jadvyga	j a d' v' i: g a
Jadzė	j A: dz' e:
Jakunienė	j a k U n' Ie n' e:
Jakūnienė	j a k u: n' Ie n' e:
Jankūnienė	j a n k u: n' Ie n' e:
Jano	j A: n o:
Janė	j A: n' e:
Janė	j a n' e:
Jasiūnaitė	j a s' u: n aI t' e:
Javta	j a v t a
Jokūbas	j o: k u: b a s
Jolita	j O l' I t a
Jolita	j O l' I t a
Jominda	j o: m' I n d a
Jonava	j o: n a v a
Jonava	j o: n a v a
Joninės	j o: n' I n' e: s
Joninės	j o: n' I n' e: s
Jonė	j o: n' e:
Josvainiai	j o: s v aI n' aI
Jovipavičių	j o: v' I p A: v' I tS' u:
Judita	j U d' I t a
Judita	j U d' I t a
Judrėnai	j U d' r' e: n aI
Julija	j U l' I j a
Jungtines	j U n' k t' I n' E s
Jungtines	j U n' k t' I n' E s
Jungtinių	j U n' k t' I n' u:
Jungtinės	j U n' k t' I n' e: s
Juodojo	j UO d o: j o:
Juozapas	j UO z a p a s
Jupiterio	j U p' I t' E r' o:
Juras	j U r a s
Jurgelionis	j U r' g' E l' o: n' I s
Jurgis	j U r' g' I s
Justina	j U s' t' I n a
Justina	j U s' t' I n a
Justė	j U s' t' e:
Juverta	j U v' E r t a
Juzefa	j U z' E f a
Juzefa	j U z' E f a
Juzė	j U z' e:
Juška	j U S k a
Juška	j U S k a
Jėzau	j e: z aU
Jūrė	j u: r' e:
Kaimelis	k aI m' {: l' I s
Kairas	k a I r a s
Kairytė	k aI r' i: t' e:
Kairėnai	k aI r' e: n aI
Kaktus	k A: k t U s
Kalbos	k a 5 b o: s
Kalbos	k a 5 b o: s
Kalvarija	k a 5 v a r' I j a
Kalvarija	k a 5 v A: r' I j a
Kalėdos	k a l' e: d o: s
Kanbera	k a n' b' E r a
Kano	k A: n o:
Karklėnai	k a r' k l' e: n aI
Kasčiūnaitė	k a S' tS' u: n aI t' e:
Katrė	k a t' r' e:
Kaubrys	k aU b' r' i: s
Kaupytė	k aU p' i: t' e:
Kaušinis	k aU S' I n' I s
Kijevas	k' I j E v a s
Kipras	k' I p r a s
Klaipėda	k 5 aI p' e: d a
Klaipėdos	k 5 aI p' e: d o: s
Kleinas	k l' EI n a s
Kleino	k l' EI n o:
Klemensas	k l' E m' E n s a s
Kleopas	k l' E O p a s
Kleopas	k l' E o: p a s
Klovainiai	k 5 o: v aI n' aI
Koncius	k O n' ts' U s
Konkurencijos	k O n k U r' E n' ts' I j o: s
Konstancija	k O n s t a n' ts' I j a
Konstitucinis	k O n' s' t' I t U ts' I n' I s
Koso	k O s o:
Kostas	k O s t a s
Kotryna	k o: t' r' i: n a
Kotryna	k o: t' r' i: n a
Krakės	k r A: k' e: s
Krasnojarskas	k r a s n O j a r s k a s
Kražiai	k r A: Z' aI
Kretinga	k r' E t' I n g a
Kretinga	k r' {: t' I n g a
Kretinga	k r' E t' I n g a
Kretingalė	k r' E t' I n g A: l' e:
Kristijonas	k r' I s' t' I j o: n a s
Kristina	k r' I s' t' I n a
Kristina	k r' I s' t' I n a
Kristupas	k r' I s t U p a s
Kriūkai	k r' u: k aI
Kroatija	k r O A: t' I j a
Kruopiai	k r UO p' aI
Kuba	k U b a
Kuba	k U b a
Kubiliūtė	k U b' I l' u: t' e:
Kuliai	k U l' aI
Kultūros	k U 5 t u: r o: s
Kupiškis	k U p' I S' k' I s
Kužiai	k U Z' aI
Kvašys	k v a S' i: s
Kybartai	k' i: b a r t aI
Kęstutis	k' {: s t U t' I s
L	E 5
L_T	E l' t' e:
L_T	E 5 t' e:
Laimis	5 aI m' I s
Laimis	5 aI m' I s
Laimutis	5 aI m U t' I s
Laimutė	5 aI m U t' e:
Lakaja	5 a k a j a
Lakaja	5 a k A: j a
Lapės	5 A: p' e: s
Laraneda	5 a r a n' E d a
Latvijoje	5 A: t' v' I j o: j E
Laurifer	5 aU r' I f' E r
Leckava	l' E ts k a v a
Leckava	l' E ts k A: v a
Leidyba	l' EI d' i: b a
Lekėčiai	l' E k' e: tS' aI
Leliūnai	l' E l' u: n aI
Lengvidžis	l' E n' g v' I dZ' I s
Leokadija	l' E O k A: d' I j a
Leonardas	l' E O n a r d a s
Leonas	l' {: O n a s
Leonas	l' E O n a s
Lidija	l' I d' I j a
Liepoja	l' Ie p o: j a
Lilijana	l' I l' I j a n a
Lilijana	l' I l' I j A: n a
Lionginas	l' O n' g' I n a s
Liublino	l' U b' l' I n o:
Liuda	l' U d a
Liuda	l' U d a
Londonas	5 O n d O n a s
Londone	5 O n d O n' E
Lopatienė	5 o: p a t' Ie n' e:
Lukoševičius	5 U k o: S' {: v' I tS' U s
Luktarna	5 U k t a r n a
Luktarna	5 U k t a r n a
Lukšiai	5 U k S' aI
Lupra	5 U p r a
Lygumai	l' i: g U m aI
Lėja	l' e: j a
M_G	E m' g' e:
Magadanas	m a g a d A: n a s
Maljorka	m a l' j O r k a
Manija	m A: n' I j a
Mantas	m a n t a s
Mantvydas	m a n' t' v' i: d a s
Marcelė	m a r' ts' E l' e:
Marcinkonys	m a r' ts' I n k o: n' i: s
Marija	m a r' I j a
Marijona	m a r' I j o: n a
Marijona	m a r' I j o: n a
Marijonas	m a r' I j o: n a s
Marytė	m a r' i: t' e:
Maskva	m a s k v a
Matuiza	m a t Ui z a
Mažasis	m a Z a s' I s
Mažeikiai	m a Z' EI k' aI
Mažeikiai	m a Z' EI k' aI
Mažeikių	m a Z' EI k' u:
Mažeikių	m a Z' EI k' u:
Mažoji	m a Z o: j I
Mb	E m' b' e:
Medijašop	m' E d' I j a S O p
Meksikoje	m' E k s' I k o: j E
Meksikos	m' E k s' I k o: s
Merkel	m' E r' k' E 5
Metai	m' {: t aI
Metropolio	m' E t r O p O l' o:
Mečislovas	m' E tS' I s 5 O v a s
Meškuičiai	m' E S k Ui tS' aI
Mickevičiūtė	m' I ts' k' E v' I tS' u: t' e:
Mielagėnai	m' Ie 5 a g' e: n aI
Miežiškiai	m' Ie Z' I S' k' aI
Mikas	m' I k a s
Milanas	m' I 5 A: n a s
Milda	m' I 5 d a
Modesta	m O d' E s t a
Modesta	m O d' E s t a
Molėtai	m o: l' e: t aI
Monakas	m O n A: k a s
Mosėdis	m o: s' e: d' I s
Muzikinė	m U z' I k' I n' e:
Naftėnas	n a f' t' e: n a s
Namavičiūtė	n a m a v' I tS' u: t' e:
Narbutaitytė	n a r b U t aI t' i: t' e:
Narbutaitė	n a r b U t aI t' e:
Narbutaitė	n a r b U t aI t' e:
Narkevičius	n a r' k' {: v' I tS' U s
Naujoji	n aU j o: j I
Nausėdai	n aU s' e: d aI
Nausėdai	n aU s' e: d aI
Nematekas	n' E m a t' E k a s
Nemunaitis	n' E m U n aI t' I s
Nemuno	n' {: m U n o:
Nerijaus	n' E r' I j aU s
Nerijus	n' E r' I j U s
Nevarėnai	n' E v a r' e: n aI
Nešas	n' E S a s
Nida	n' I d a
Nida	n' I d a
Nijolė	n' I j o: l' e:
Nijolė	n' I j O l' e:
Nomeda	n o: m' E d a
Nomeda	n o: m' E d a
Nomeda	n o: m' {: d a
Nomeda	n o: m' E d a
Norvelita	n O r' v' E l' I t a
Of	O f
Oksana	O k s a n a
Oksana	O k s A: n a
Olimpo	O l' I m p o:
Ona	o: n a
Onelė	o: n' {: l' e:
Oro	o: r o:
Osvaldas	O s v a 5 d a s
Pabradė	p a b r a d' e:
Pabradė	p a b r A: d' e:
Pagiriai	p a g' I r' aI
Pagramantis	p A: g r a m a n' t' I s
Pagėgiai	p a g' e: g' aI
Pajūris	p a j u: r' I s
PakMarkas	p a k m a r k a s
Palėvenė	p a l' e: v' E n' e:
Pandėlys	p a n' d' e: l' i: s
Panevėžio	p A: n' E v' e: Z' o:
Panevėžys	p a n' E v' e: Z' i: s
Papilė	p a p' I l' e:
Paryžiuje	p a r' i: Z' U j E
Pasvalys	p a s v a l' i: s
Paupiai	p a U p' aI
Pavandenė	p A: v a n' d' E n' e:
Pašušvys	p a S U S' v' i: s
Pekinas	p' E k' I n a s
Pervalka	p' E r v a 5 k a
Peterburgas	p' E t' E r b U r g a s
Petkevičaitė	p' E t' k' E v' I tS aI t' e:
Petraitienė	p' E t r aI t' Ie n' e:
Petras	p' {: t r a s
Petrauskas	p' E t r aU s k a s
Petrašiūnai	p' E t r a S' u: n aI
Petro	p' {: t r o:
Pieno	p' Ie n o:
Pigu	p' I g U
Pišcikaitė	p' I S' ts' I k aI t' e:
Plungė	p 5 U n' g' e:
Plytinė	p' l' i: t' I n' e:
Pranckūnas	p r a n ts k u: n a s
Prancūzijoje	p r a n ts u: z' I j o: j E
Prancūzijos	p r a n ts u: z' I j o: s
Pranė	p r A: n' e:
Preila	p' r' EI 5 a
Preilių	p' r' EI l' u:
Prezidentas	p' r' E z' I d' E n t a s
Prioro	p' r' O r o:
Pro	p r O
Progreso	p r O g r' E s o:
Puidokas	p Ui d o: k a s
Pušalotas	p U S a 5 o: t a s
Radviliškis	r a d' v' I l' I S' k' I s
Raimondas	r aI m O n d a s
Raminta	r a m' I n t a
Ramoška	r a m o: S k a
Ramoška	r a m o: S k a
Ramygala	r a m' i: g a 5 a
Ramūnas	r a m u: n a s
Raseiniai	r a s' EI n' aI
Registrų	r' E g' I s t r u:
Reikjavikas	r' EI k j a v' I k a s
Reladus	r' E 5 A: d U s
Rever	r' E v' E r
Rietavas	r' Ie t A: v a s
Rimgaudas	r' I m g aU d a s
Rimkevičienė	r' I m' k' {: v' I tS' Ie n' e:
Rimvydas	r' I m' v' i: d a s
Ričardas	r' I tS a r d a s
Robertas	r O b' E r t a s
Romutė	r O m U t' e:
Romutė	r o: m U t' e:
Rožė	r o: Z' e:
Rumpiškė	r U m' p' I S' k' e:
Rupšytė	r U p' S' i: t' e:
Rusija	r U s' I j a
Ruslanas	r U s 5 A: n a s
Ruželė	r U Z' {: l' e:
Ryga	r' i: g a
Ryga	r' i: g a
Rūta	r u: t a
Rūta	r u: t a
Sakalauskienė	s a k a 5 aU s' k' Ie n' e:
Salamiestis	s a 5 A: m' Ie s' t' I s
Saldutiškis	s a 5 d U t' I S' k' I s
Salora	s a 5 O r a
Sanitas	s A: n' I t a s
Sankt	s a n k t
Santariškės	s a n t a r' I S' k' e: s
Santariškės	s a n t a r' I S' k' e: s
Seime	s' EI m' E
Seimui	s' EI m Ui
Seirijai	s' EI r' I j aI
Serbijos	s' E r' b' I j o: s
Seredžius	s' E r' {: dZ' U s
Sicilija	s' I ts' I l' I j a
Silvanavičius	s' I 5 v a n A: v' I tS' U s
Simnas	s' I m n a s
Simpeksa	s' I m' p' E k s a
Simpeksa	s' I m' p' E k s a
Simsonienė	s' I m s O n' Ie n' e:
Sirijos	s' I r' I j o: s
Siriją	s' I r' I j A:
Skaistgirys	s k aI z' d' g' I r' i: s
Skaudvilė	s k aU d' v' I l' e:
Skliutauskas	s' k l' U t aU s k a s
Skubus	s k U b U s
Skuodas	s k UO d a s
Slovėniją	s 5 O v' e: n' I j A:
Smeltė	s' m' E l' t' e:
Socialdemokratų	s O ts' I j a l' d' E m O k r A: t u:
Socialdemokratų	s O ts' a l' d' E m O k r A: t u:
Spaineta	s p aI n' E t a
Spaineta	s p aI n' E t a
Stanislovas	s t a n' I s 5 O v a s
Stasys	s t a s' i: s
Stasė	s t A: s' e:
Steponas	s' t' {: p O n a s
Straigaitienė	s t r aI g aI t' Ie n' e:
Straigienė	s t r aI g' Ie n' e:
Strėžiūnų	s' t' r' e: Z' u: n u:
Sudeikiai	s U d' EI k' aI
Suomija	s UO m' I j a
Sutaras	s U t a r a s
Suvalkiją	s U v a l' k' I j A:
Svetlana	s' v' E t 5 a n a
Svetlana	s' v' E t 5 A: n a
Sąjunga	s A: j U n g a
T_V	t' e: v' e:
Talinas	t A: l' I n a s
Tamulionienė	t a m U l' o: n' Ie n' e:
Tamėlaitė	t a m' e: 5 aI t' e:
Tamėlaitė	t a m' e: 5 aI t' e:
Tauragėje	t aU r a g' e: j E
Tauralaukis	t aU r A: 5 aU k' I s
Tautvydas	t aU t' v' i: d a s
Teisinių	t' EI s' I n' u:
Teklė	t' {: k l' e:
Teklė	t' E k l' e:
Tev	t' E v
The	t' G' E
Tirkšliai	t' I r' k S' l' aI
Topo	t O p O
Trakų	t r a k u:
Trakų	t r A: k u:
Transtira	t r a n' s' t' I r a
Transtira	t r a n' s' t' I r a
Trapulionis	t r a p U l' o: n' I s
Traškelienė	t r a S' k' {: l' Ie n' e:
Truskava	t r U s k a v a
Tryškiai	t' r' i: S' k' aI
Turkijos	t U r' k' I j o: s
Tutanchamono	t U t a n x a m O n o:
Tverečius	t' v' E r' {: tS' U s
Tytuvėnai	t' i: t U v' e: n aI
Tytuvėnuose	t' i: t U v' e: n UO s' E
Ugnė	U g n' e:
Ukmergė	U k m' E r' g' e:
Ukrainoje	U k r a I n o: j E
Vaidotas	v aI d o: t a s
Vainutas	v aI n U t a s
Vaivilavičius	v aI v' I 5 A: v' I tS' U s
Vaizdų	v aI z d u:
Vaizdų	v aI z d u:
Valakampiai	v a 5 A: k a m' p' aI
Valentas	v A: l' E n t a s
Valentas	v a l' E n t a s
Valentinas	v a l' E n' t' I n a s
Valerija	v a l' E r' I j a
Valiukevičienė	v a l' U k' {: v' I tS' Ie n' e:
Valius	v A: l' U s
Valstijos	v a l' s' t' I j o: s
Valstybinės	v a l' s' t' i: b' I n' e: s
Valstybės	v a l' s' t' i: b' e: s
Valė	v A: l' e:
Varėna	v a r' e: n a
Varėna	v a r' e: n a
Varšuva	v a r S U v a
Vasiulytė	v a s' U l' i: t' e:
Vatikano	v a t' I k A: n o:
Vedrickas	v' E d' r' I ts k a s
Veisiejai	v' EI s' Ie j aI
Veisiejai	v' EI s' Ie j aI
Venecijoje	v' E n' E ts' I j o: j E
Venecijos	v' E n' E ts' I j o: s
Verksnienė	v' E r' k s' n' Ie n' e:
Veronika	v' E r O n' I k a
Verticia	v' E r' t' I ts' I j a
Vertimas	v' E r' t' I m a s
Vidmantė	v' I d m a n' t' e:
Vidmantė	v' I d m a n' t' e:
Vigesta	v' I g' E s t a
Vigesta	v' I g' E s t a
Viktoras	v' I k t O r a s
Viktorija	v' I k t O r' I j a
Vilija	v' I l' I j a
Vilius	v' I l' U s
Vilius	v' I l' U s
Vilkas	v' I 5 k a s
Vilkaviškis	v' I 5 k a v' I S' k' I s
Vilkija	v' I l' k' I j a
Vilkija	v' I l' k' I j a
Vilkija	v' I l' k' I j a
Vilkis	v' I l' k' I s
Vilkritis	v' I l' k r' I t' I s
Vilnika	v' I l' n' I k a
Vilniuje	v' I l' n' U j E
Virbickas	v' I r' b' I ts k a s
Virginijus	v' I r' g' I n' I j U s
Viršuliškės	v' I r S U l' I S' k' e: s
Visagino	v' I s a g' I n o:
Vita	v' I t a
Vita	v' I t a
Vitalija	v' I t A: l' I j a
Vokietija	v o: k' Ie t' I j a
Vokietijos	v o: k' Ie t' I j o: s
Vokė	v o: k' e:
Vosylienė	v o: s' i: l' Ie n' e:
Vyja	v' i: j a
Vyriausybė	v' i: r' aU s' i: b' e:
Vytulis	v' i: t U l' I s
Vėlyvis	v' e: l' i: v' I s
Zarasai	z a r a s aI
Zita	z' I t a
Zita	z' I t a
Zokniuose	z o: k n' UO s' E
Zubkienė	z U p' k' Ie n' e:
Zubkienė	z U p' k' Ie n' e:
Zuzi	z U z' I
abejoja	a b' E j o: j a
abi	a b' I
abipus	a b' I p U s
absoliučiai	a p s O l' U tS' aI
absoliučiai	a p s O l' U tS' aI
abu	a b U
abėcėlė	a b' e: ts' e: l' e:
administracija	a d' m' I n' I s t r A: ts' I j a
administratoriai	a d' m' I n' I s t r A: t O r' aI
aikštę	aI k S' t' {:
aistra	aI s t r a
aistra	aI s t r a
aistringiausi	aI s' t' r' I n' g' aU s' I
aiškiai	aI S' k' aI
aiškinosi	aI S' k' I n o: s' I
aiškus	aI S k U s
akcinė	A: k ts' I n' e:
akimirkos	a k' I m' I r k o: s
akiratį	a k' I r a t' i:
akivaizdu	a k' I v aI z d U
aklas	A: k 5 a s
aklas	a k 5 a s
akmenis	A: k m' E n' I s
akmens	a k m' E n s
akmenys	A: k m' E n' i: s
aktoriai	A: k t o: r' aI
aktorė	A: k t O r' e:
aktuali	a k t U a l' I
aktyvumo	a k t' i: v U m o:
alergijomis	a l' E r' g' I j o: m' I s
alfabetas	a 5 f a b' E t a s
algas	a 5 g a s
alkanas	a 5 k a n a s
alkanas	a 5 k a n a s
alsuojančią	a 5 s UO j a n' tS' A:
alternatyvos	a l' t' E r n a t' i: v o: s
alus	a 5 U s
amerikietis	a m' E r' I k' Ie t' I s
amerikiečiui	a m' E r' I k' Ie tS' Ui
amnezija	a m' n' E z' I j a
amžiaus	a m' Z' aU s
amžinas	a m' Z' I n a s
amžiuje	a m' Z' U j E
amžius	a m' Z' U s
angys	a n' g' i: s
anksto	a n k s t o:
antrais	a n t r aI s
antras	a n t r a s
antras	a n t r a s
antrieji	a n' t' r' Ie j I
antro	a n t r o:
antroje	a n t r o: j E
antrąją	a n t r A: j A:
antrąjį	a n t r A: j i:
antys	a n' t' i: s
apetitą	a p' E t' I t A:
apgyvendinimas	a b' g' i: v' E n' d' I n' I m a s
apibrėžtas	a p' I b' r' e: S t a s
apibūdinti	a p' I b u: d' I n' t' I
apima	a p' I m a
apimta	a p' I m t a
apimta	a p' I m t a
apkaltintas	a p k a l' t' I n t a s
apklausti	a p k 5 aU s' t' I
apklausti	a p k 5 aU s' t' I
aplankys	a p 5 a n' k' i: s
aplankyti	a p 5 a n' k' i: t' I
aplankę	a p 5 a n' k' {:
aplenkti	a p' l' E n' k t' I
aplenkti	a p' l' E n' k t' I
aplink	a p' l' I n k
aplinka	a p' l' I n k a
aplinkoje	a p' l' I n k o: j E
aplinkos	a p' l' I n k o: s
aplinkosaugos	a p' l' I n k o: s aU g o: s
aplinkybių	a p' l' I n' k' i: b' u:
aplinkybės	a p' l' I n' k' i: b' e: s
apraibo	a p r aI b o:
apriboti	a p' r' I b o: t' I
apsirengti	a p' s' I r' E n' k t' I
apsisaugoti	a p' s' I s aU g o: t' I
apsivilkau	a p' s' I v' I 5 k aU
apskrities	a p' s' k r' I t' Ie s
apskundė	a p s k U n' d' e:
apstulbo	a p s t U 5 b o:
aptarnavo	a p t a r n A: v o:
aptiktas	a p' t' I k t a s
apvalinti	a p v A: l' I n' t' I
apygardos	a p' i: g a r d o: s
apygardų	a p' i: g a r d u:
apčiuopia	a p' tS' UO p' a
apžiūra	a b' Z' u: r a
apžiūra	A: b' Z' u: r a
apžiūrėjo	a b' Z' u: r' e: j o:
apžvelgiami	a b' Z' v' E l' g' a m' I
arbatos	a r b A: t o: s
archeologinius	a r' x' E O 5 O g' I n' U s
architektūrinės	a r' x' I t' E k t u: r' I n' e: s
argumento	a r g U m' E n t o:
arklio	a r' k l' o:
arkliui	a r' k l' Ui
arklys	a r' k l' i: s
arklį	a r' k l' i:
armonika	a r m O n' I k a
armonika	a r m o: n' I k a
artimiausią	a r' t' I m' aU s' A:
artimieji	a r' t' I m' Ie j I
artėja	a r' t' e: j a
artėjančiai	a r' t' e: j a n' tS' aI
asmeniui	A: s' m' E n' Ui
asmeniškai	a s' m' {: n' I S k aI
asmens	a s' m' E n s
asmenybės	a s' m' E n' i: b' e: s
asmuo	a s m UO
ataka	a t a k a
ataka	a t A: k a
atgaivina	a d g aI v' I n a
atgaline	a d g a l' I n' E
atgaline	a d g a l' I n' E
atidėtas	a t' I d' e: t a s
atidėtas	a t' I d' e: t a s
atkakliai	a t k A: k l' aI
atkakliai	a t k a k l' aI
atkimšk	a t' k' I m S k
atkurti	a t k U r' t' I
atkurti	a t k U r' t' I
atlaikyti	a t 5 aI k' i: t' I
atleidimą	a t' l' EI d' I m A:
atleisk	a t' l' EI s k
atliko	a t' l' I k o:
atlikėjo	a t' l' I k' e: j o:
atlyginimo	a t' l' i: g' I n' I m o:
atminti	a t' m' I n' t' I
atminti	a t' m' I n' t' I
atminti	a t' m' I n' t' I
atominė	a t O m' I n' e:
atostogas	a t o: s t o: g a s
atostogauti	a t o: s t o: g aU t' I
atpažįstama	a t p a Z' i: s t a m a
atpažįstama	a t p a Z' i: s t a m a
atplaukė	a t p 5 aU k' e:
atrankos	a t r a n k o: s
atrankos	A: t r a n k o: s
atrastas	a t r a s t a s
atrastas	a t r a s t a s
atrašysime	a t r a S' i: s' I m' E
atrašė	a t r A: S' e:
atrinktus	a t' r' I n k t U s
atrodančios	a t r o: d a n' tS' o: s
atsakingas	a t s a k' I n g a s
atsakingi	a t s a k' I n' g' I
atsakingiems	a t s a k' I n' g' Ie m s
atsako	a t s A: k o:
atsako	A: t s a k o:
atsakomybę	a t s a k o: m' i: b' {:
atsiduria	a t' s' I d U r' a
atsigręžęs	a t' s' I g r' {: Z' {: s
atsikeldavom	a t' s' I k' E 5 d a v O m
atsikraustė	a t' s' I k r aU s' t' e:
atsineša	a t' s' I n' E S a
atsisakęs	a t' s' I s A: k' {: s
atsitikimų	a t' s' I t' I k' I m u:
atsitiktinai	a t' s' I t' I k t' I n aI
atsižvelgiant	a t' s' I Z' v' E l' g' a n t
atskiras	A: t' s' k' I r a s
atskleidžia	a t' s' k l' EI dZ' a
atskleidžia	a t' s' k l' EI dZ' a
atskleisti	a t' s' k l' EI s' t' I
atskleisti	a t' s' k l' EI s' t' I
atspalvį	A: t s p a l' v' i:
atstovai	a t s t o: v aI
atstovas	a t s t o: v a s
atstovavimą	a t s t o: v A: v' I m A:
atstumus	a t s t U m U s
atvažiavusi	a t v a Z' A: v U s' I
atveda	a t' v' E d a
atvejį	A: t' v' E j i:
atvyko	a t' v' i: k o:
atvykstančių	a t' v' i: k s t a n' tS' u:
atvykusius	a t' v' i: k U s' U s
atvykėliai	a t' v' i: k' e: l' aI
atvėrė	a t' v' e: r' e:
atėjus	a t' e: j U s
atšipo	a t' S' I p o:
auga	aU g a
augalas	aU g a 5 a s
augantį	aU g a n' t' i:
augančias	aU g a n' tS' a s
auginimui	aU g' I n' I m Ui
aukcionuose	aU k ts' I j O n UO s' E
auklėti	aU k l' e: t' I
aukštai	aU k S t aI
aukštai	aU k S t aI
aukštai	aU k S t aI
aukštesniąją	aU k S' t' E s' n' A: j A:
aukšto	aU k S t o:
aukšto	aU k S t o:
aukštojo	aU k S t o: j o:
aukštosios	aU k S t o: s' o: s
aukštosios	aU k S t o: s' o: s
aukštą	aU k S t A:
aukštą	aU k S t A:
aukštų	aU k S t u:
aukštų	aU k S t u:
aukščiausia	aU k S' tS' aU s' a
ausis	aU s' I s
ausis	aU s' I s
autobusai	aU t O b U s aI
autobusas	aU t O b U s a s
automobiliais	aU t O m O b' I l' aI s
automobilio	aU t O m O b' I l' o:
automobilius	aU t O m O b' I l' U s
automobilyje	aU t O m O b' I l' i: j E
autoriai	aU t O r' aI
autoriteto	aU t O r' I t' E t o:
autorius	aU t O r' U s
autorė	aU t O r' e:
autostopu	aU t O s t O p U
avies	a v' Ie s
azerbaidžaniečiai	a z' E r b aI dZ a n' Ie tS' aI
ašmenis	A: S' m' E n' I s
aštoun	a S t OU n
aštuntas	a S t U n t a s
aštuntas	a S t U n t a s
aštuntoji	a S t U n t o: j I
aštuntos	a S t U n t o: s
aštuntos	a S t U n t o: s
aštuon	a S t UO n
aštuoniasdešimtų	a S t UO n' a z' d' E S' I m t u:
aštuoniasdešimtųjų	a S t UO n' a z' d' E S' I m t u: j u:
aštuonšimt	a S t UO n' S' I m t
bado	b A: d o:
bagažas	b a g A: Z a s
baigiasi	b aI g' a s' I
baigs	b aI k s
baigti	b aI k t' I
baigti	b aI k t' I
baimė	b aI m' e:
baimės	b aI m' e: s
baimę	b aI m' {:
bakterijų	b a k t' E r' I j u:
balandį	b a 5 a n' d' i:
baldų	b a 5 d u:
balsas	b a 5 s a s
balsavo	b a 5 s A: v o:
balsu	b a 5 s U
baltu	b a 5 t U
bando	b a n d o:
bandys	b a n' d' i: s
banga	b a n g a
banga	b a n g a
bangos	b a n g o: s
bangos	b a n g o: s
bankai	b a n k aI
banko	b a n k o:
bankų	b a n k u:
baudžiamojoje	b aU dZ' a m o: j o: j E
bausmes	b aU s' m' E s
bausmę	b aU s' m' {:
bazilikas	b a z' I l' I k a s
bazės	b A: z' e: s
bažnyčia	b a Z' n' i: tS' a
bedarbystei	b' E d a r' b' i: s' t' EI
belgai	b' E 5 g aI
bendra	b' E n d r a
bendra	b' E n d r a
bendravimo	b' E n d r A: v' I m o:
bendrovės	b' E n d r o: v' e: s
bent	b' E n t
bent	b' E n t
beprotiškai	b' E p r o: t' I S k aI
berniuko	b' E r' n' U k o:
besidominčių	b' E s' I d o: m' I n' tS' u:
bevardės	b' E v a r' d' e: s
bijau	b' I j aU
bijo	b' I j o:
biliardo	b' I l' I j a r d o:
bimo	b' I m o:
biologija	b' I j O 5 O g' I j a
biologija	b' I O 5 O g' I j a
biologinę	b' I j O 5 O g' I n' {:
birža	b' I r Z a
bitė	b' I t' e:
biuro	b' U r o:
bičiuli	b' I tS' U l' I
blogai	b 5 o: g aI
blogio	b 5 o: g' o:
bokštas	b o: k S t a s
bomba	b O m b a
bombarduoja	b O m b a r d UO j a
bombą	b O m b A:
brandina	b r a n' d' I n a
brandintą	b r a n' d' I n t A:
brandžiai	b r a n' dZ' aI
brandžiuose	b r a n' dZ' UO s' E
brangias	b r a n' g' a s
brangių	b r a n' g' u:
briedžiai	b' r' Ie dZ' aI
brolis	b r o: l' I s
bruožais	b r UO Z aI s
brūkšnelis	b r u: k S' n' {: l' I s
budėjimui	b U d' e: j I m Ui
buhalterijos	b U G a l' t' E r' I j o: s
buvusi	b U v U s' I
buvusiam	b U v U s' a m
buvusios	b U v U s' o: s
buvę	b U v' {:
byla	b' i: 5 a
byla	b' i: 5 a
bėdos	b' e: d o: s
bėdos	b' e: d o: s
bėgdami	b' e: g d a m' I
bėgiojo	b' e: g' o: j o:
bėgių	b' e: g' u:
bėgtų	b' e: k t u:
būdais	b u: d aI s
būdama	b u: d a m a
būdamas	b u: d a m a s
būdavo	b u: d a v o:
būdinga	b u: d' I n g a
būdingas	b u: d' I n g a s
būdingi	b u: d' I n' g' I
būna	b u: n a
būseną	b u: s' E n A:
būsimą	b u: s' I m A:
celsis	ts' E l' s' I s
cementas	ts' E m' E n t a s
cementas	ts' E m' E n t a s
centras	ts' E n t r a s
centrine	ts' E n' t' r' I n' E
centrinio	ts' E n' t' r' I n' o:
centrinę	ts' E n' t' r' I n' {:
centruose	ts' E n t r UO s' E
ceremonija	ts' E r' E m O n' I j a
chalatu	x a 5 a t U
chalatu	x a 5 A: t U
charakterį	x a r A: k t' E r' i:
chemija	x' E m' I j a
ciklus	ts' I k 5 U s
cinis	ts' I n' I s
citatos	ts' I t A: t o: s
civilinių	ts' I v' I l' I n' u:
civilizacija	ts' I v' I l' I z A: ts' I j a
cukraininių	ts U k r aI n' I n' u:
cukrainių	ts U k r aI n' u:
cukralige	ts U k r A: l' I g' E
cukrus	ts U k r U s
dabartinė	d a b a r' t' I n' e:
daiktavardžių	d aI k t A: v a r' dZ' u:
daikto	d aI k t o:
daiktų	d aI k t u:
dailininkas	d aI l' I n' I n k a s
dainelės	d aI n' {: l' e: s
dainingiausias	d aI n' I n' g' aU s' a s
dainininkei	d aI n' I n' I n' k' EI
dainininko	d aI n' I n' I n k o:
dainininkė	d aI n' I n' I n' k' e:
dainuoja	d aI n UO j a
dainą	d aI n A:
dainų	d aI n u:
dalgių	d a l' g' u:
dalgį	d a l' g' i:
dalim	d a l' I m
dalim	d a l' I m
dalimi	d a l' I m' I
dalinama	d a l' I n a m a
dalykai	d a l' i: k aI
dalykus	d a l' i: k U s
dalykus	d a l' i: k U s
dalyvavimas	d a l' i: v A: v' I m a s
dalyvavims	d a l' i: v A: v' I m s
dalyviai	d a l' i: v' aI
dalį	d A: l' i:
dantų	d a n t u:
darbai	d a r b aI
darbdavys	d a r b d a v' i: s
darbiaujant	d a r' b' aU j a n t
darbuotoja	d a r b UO t o: j a
darbuotojus	d a r b UO t o: j U s
darže	d a r' Z' E
darže	d a r' Z' E
darželį	d a r' Z' {: l' i:
daržininkystės	d a r' Z' I n' I n' k' i: s' t' e: s
daržo	d a r Z o:
data	d a t a
data	d A: t a
daugelį	d aU g' E l' i:
daugiabučio	d aU g' a b U tS' o:
daugiausiai	d aU g' aU s' aI
daugybei	d aU g' i: b' EI
daugybė	d aU g' i: b' e:
dažai	d a Z aI
dažnas	d A: Z n a s
dažnesnės	d a Z' n' E s' n' e: s
dažnesnės	d a Z' n' E s' n' e: s
debesys	d' {: b' E s' i: s
defektus	d' E f' E k t U s
deficitas	d' E f' I ts' I t a s
degantis	d' {: g a n' t' I s
deja	d' E j a
deldžolų	d' E 5 dZ o: 5 u:
demaskavo	d' E m a s k A: v o:
demografinį	d' E m O g r A: f' I n' i:
departamento	d' E p a r t a m' E n t o:
depresija	d' E p' r' E s' I j a
derlinga	d' E r' l' I n g a
desantinis	d' E s a n' t' I n' I s
devintais	d' E v' I n t aI s
devintajame	d' E v' I n t A: j a m' E
devintą	d' E v' I n t A:
devyniasdešimti	d' E v' i: n' a z' d' E S' I m' t' I
devyniasdešimtieji	d' E v' i: n' a z' d' E S' I m' t' Ie j I
devyniasdešimtų	d' E v' i: n' a z' d' E S' I m t u:
devyniasdešimtų	d' E v' i: n' a z' d' E S' I m t u:
devyniasdešimtųjų	d' E v' i: n' a z' d' E S' I m t u: j u:
devynioliktame	d' E v' i: n' o: l' I k t a m' E
devynioliktą	d' E v' i: n' o: l' I k t A:
devynioliktųjų	d' E v' i: n' o: l' I k t u: j u:
dešimtmetis	d' E S' I m' t' m' E t' I s
dešimtmetis	d' E S' I m' t' m' {: t' I s
dešimtmetį	d' E S' I m' t' m' E t' i:
dešimtmetį	d' E S' I m' t' m' {: t' i:
dešimtos	d' E S' I m t o: s
dešimtos	d' E S' I m t o: s
dešimtys	d' {: S' I m' t' i: s
dešimtų	d' E S' I m t u:
dešines	d' {: S' I n' E s
dešinės	d' E S' I n' e: s
didele	d' I d' E l' E
dideliems	d' I d' E l' Ie m s
didelis	d' I d' E l' I s
dideliu	d' I d' E l' U
didelių	d' I d' E l' u:
didelė	d' I d' E l' e:
didelį	d' I d' E l' i:
didesnis	d' I d' E s' n' I s
didesnė	d' I d' E s' n' e:
didesnį	d' I d' E s' n' i:
didikų	d' I d' I k u:
didinti	d' I d' I n' t' I
didėjančiai	d' I d' e: j a n' tS' aI
didžiausia	d' I dZ' aU s' a
didžiausio	d' I dZ' aU s' o:
didžiausią	d' I dZ' aU s' A:
didžiausių	d' I dZ' aU s' u:
didžiule	d' I dZ' U l' E
didžiulei	d' I dZ' U l' EI
didžiuliai	d' I dZ' U l' aI
didžiulė	d' I dZ' U l' e:
didžiuotis	d' I dZ' UO t' I s
didžiąją	d' I dZ' A: j A:
didžkukuliai	d' I tS k U k U l' aI
dienas	d' Ie n a s
dievų	d' Ie v u:
diktatoriai	d' I k t A: t O r' aI
dirba	d' I r b a
dirbame	d' I r b a m' E
dirbantis	d' I r b a n' t' I s
dirbsiu	d' I r' p' s' U
dirbtini	d' I r' p' t' I n' I
dirbtinio	d' I r' p' t' I n' o:
dirbtinė	d' I r' p' t' I n' e:
direktoriaus	d' I r' E k t O r' aU s
diržas	d' I r Z a s
diskriminacijos	d' I s' k r' I m' I n A: ts' I j o: s
dokumentas	d O k U m' E n t a s
dominančios	d o: m' I n a n' tS' o: s
dominęs	d o: m' I n' {: s
domisi	d o: m' I s' I
domėjimasis	d o: m' e: j I m a s' I s
domėjosi	d o: m' e: j o: s' I
dorą	d o: r A:
dovanas	d o: v a n a s
dovanojo	d o: v a n o: j o:
draudimas	d r aU d' I m a s
draudimo	d r aU d' I m o:
draugai	d r aU g aI
draugės	d r aU g' e: s
draugės	d r aU g' e: s
draugų	d r aU g u:
draugų	d r aU g u:
draškėjo	d r a S' k' e: j o:
dribsniai	d' r' I p' s' n' aI
driekiasi	d' r' Ie k' a s' I
drovumo	d r o: v U m o:
drąsos	d r A: s o: s
drąsos	d r A: s o: s
dukart	d U k a r t
dukcijoje	d U k ts' I j o: j E
dukrą	d U k r A:
duonos	d UO n o: s
duoną	d UO n A:
duris	d U r' I s
durys	d U r' i: s
dvaras	d v A: r a s
dvarą	d v A: r A:
dvasia	d v a s' a
dvasia	d v A: s' a
dvidešimties	d' v' I d' E S' I m' t' Ie s
dvidešimties	d' v' I d' E S' I m' t' Ie s
dvidešimtmetis	d' v' I d' E S' I m' t' m' E t' I s
dvidešimtmetis	d' v' I d' E S' I m' t' m' {: t' I s
dvidešimto	d' v' I d' E S' I m t o:
dvidešimto	d' v' I d' E S' I m t o:
dvidešimtoji	d' v' I d' E S' I m t o: j I
dvidešimtųjų	d' v' I d' E S' I m t u: j u:
dvigubai	d' v' I g U b aI
dvikalbių	d' v' I k a l' b' u:
dvikovai	d' v' I k o: v aI
dviračiai	d' v' I r a tS' aI
dviračiai	d' v' I r A: tS' aI
dviračiu	d' v' I r a tS' U
dviračiu	d' v' I r a tS' U
dviračių	d' v' I r a tS' u:
dviračių	d' v' I r A: tS' u:
dvylikta	d' v' i: l' I k t a
dvyliktoje	d' v' i: l' I k t o: j E
dvyliktą	d' v' i: l' I k t A:
dydį	d' i: d' i:
dydžių	d' i: dZ' u:
dykumose	d' i: k U m o: s' E
dzenbudistės	dz' E n b U d' I s' t' e: s
dzimbinėja	dz' I m' b' I n' e: j a
dzingtelėjo	dz' I n' k t' E l' e: j o:
dzinguliai	dz' I n g U l' aI
dzinguliuoja	dz' I n g U l' UO j a
dzingėjimas	dz' I n' g' e: j I m a s
dzirina	dz' I r' I n a
dzūkams	dz u: k a m s
dzūkavimu	dz u: k A: v' I m U
dzūkuoja	dz u: k UO j a
dzūkuoti	dz u: k UO t' I
dzūkus	dz u: k U s
dzūkus	dz u: k U s
dzūkų	dz u: k u:
dėkingumas	d' e: k' I n g U m a s
dėklą	d' e: k 5 A:
dėlto	d' e: 5 t o:
dėmesys	d' e: m' E s' i: s
dėmesį	d' e: m' E s' i:
dėstyti	d' e: s' t' i: t' I
džabyjam	dZ A: b' i: j a m
džaglyjo	dZ A: g l' i: j o:
džalga	dZ a 5 g a
džalga	dZ a 5 g a
džalgės	dZ a l' g' e: s
džalyjamas	dZ A: l' i: j a m a s
džalyji	dZ A: l' i: j I
džalyjo	dZ A: l' i: j o:
džalyti	dZ A: l' i: t' I
džamė	dZ A: m' e:
džamės	dZ A: m' e: s
džandžaras	dZ a n dZ A: r a s
džandžaru	dZ a n dZ a r U
džandžaru	dZ a n dZ A: r U
džandžolai	dZ a n dZ o: 5 aI
džandžolais	dZ a n dZ o: 5 aI s
džandžolus	dZ a n dZ o: 5 U s
džandžolus	dZ a n dZ o: 5 U s
džangsta	dZ a n k s t a
džangsėjimas	dZ a n' k s' e: j I m a s
džardžėti	dZ a r' dZ' e: t' I
džarškėjimas	dZ a r' S' k' e: j I m a s
džatakomis	dZ A: t a k o: m' I s
džaulis	dZ aU l' I s
džavikę	dZ a v' I k' {:
džerimanderingu	dZ' E r' I m a n' d' E r' I n g U
džerimanderingą	dZ' E r' I m a n' d' E r' I n g A:
džiaugiamės	dZ' aU g' a m' e: s
džiaugiasi	dZ' aU g' a s' I
džiaugsmą	dZ' aU k s m A:
džingsi	dZ' I n' k s' I
džiovintus	dZ' o: v' I n t U s
džiugina	dZ' U g' I n a
džiugios	dZ' U g' o: s
džiugios	dZ' U g' o: s
džiugiu	dZ' U g' U
džvikėmis	dZ' v' I k' e: m' I s
efektyviai	E f' E k t' i: v' aI
egzaminas	E g z A: m' I n a s
egzistencijai	E g z' I s' t' E n' ts' I j aI
egzistuoja	E g z' I s t UO j a
egzistuojančias	E g z' I s t UO j a n' tS' a s
egzotini	E g z O t' I n' I
egzotiškas	E g z O t' I S k a s
eiles	EI l' E s
eilini	EI l' I n' I
eilės	EI l' e: s
eilės	EI l' e: s
eilėse	EI l' e: s' E
eiseną	EI s' E n A:
eisime	EI s' I m' E
eismo	EI s m o:
eiti	EI t' I
eiti	EI t' I
eklektikos	E k l' E k t' I k o: s
ekonomiką	E k O n O m' I k A:
ekonomiškiausias	E k O n O m' I S' k' aU s' a s
ekonomiško	E k O n O m' I S k o:
ekrano	E k r A: n o:
ekscentriškumo	E k s' ts' E n' t' r' I S k U m o:
ekskursijos	E k s k U r' s' I j o: s
ekspertė	E k s' p' E r' t' e:
eksportuotų	E k s p O r t UO t u:
ekspozicijoms	E k s p O z' I ts' I j O m s
elektrinis	E l' E k t' r' I n' I s
elektrinė	E l' E k t' r' I n' e:
elektromobiliams	E l' E k t r O m O b' I l' a m s
elektroninio	E l' E k t r O n' I n' o:
elgesio	E l' g' E s' o:
emigrantų	E m' I g r a n t u:
emocinė	E m O ts' I n' e:
emocinę	E m O ts' I n' {:
energija	E n' E r' g' I j a
entuziastingai	E n t U z' I j a s' t' I n g aI
entuziazmo	E n t U z' I j A: z m o:
eros	E r o: s
erzina	E r' z' I n a
esame	{: s a m' E
esanti	{: s a n' t' I
esantį	{: s a n' t' i:
esąs	{: s A: s
esąs	E s A: s
etapo	E t A: p o:
etninį	E t' n' I n' i:
etnografinių	E t n O g r A: f' I n' u:
etnografinės	E t n O g r A: f' I n' e: s
etnokultūrinių	E t n O k U 5 t u: r' I n' u:
europiečius	EU r O p' Ie tS' U s
europiečius	EU r O p' Ie tS' U s
evakuotas	E v a k UO t a s
faktais	f A: k t aI s
faktorių	f A: k t O r' u:
faktų	f A: k t u:
fantastinę	f a n t A: s' t' I n' {:
faraono	f a r a O n o:
festivaliai	f' E s' t' I v A: l' aI
festivaliais	f' E s' t' I v A: l' aI s
festivalio	f' E s' t' I v A: l' o:
festivalyje	f' E s' t' I v A: l' i: j E
fiktyvius	f' I k t' i: v' U s
fiktyvius	f' I k t' i: v' U s
fiktyvus	f' I k t' i: v U s
filmą	f' I 5 m A:
filmų	f' I 5 m u:
filosofiniais	f' I 5 O s O f' I n' aI s
finansavimas	f' I n a n s A: v' I m a s
finansinės	f' I n a n' s' I n' e: s
finansų	f' I n a n s u:
firma	f' I r m a
fizikinis	f' I z' I k' I n' I s
fizikos	f' I z' I k o: s
fizinio	f' I z' I n' o:
fizinė	f' I z' I n' e:
fizinę	f' I z' I n' {:
fiziologiją	f' I z' I j O 5 O g' I j A:
folkloro	f O 5 k 5 O r o:
fonas	f O n a s
fonde	f O n' d' E
formų	f O r m u:
fragmentiškumą	f r a g m' E n' t' I S k U m A:
frakciją	f r A: k ts' I j A:
fundamentali	f U n d a m' E n t a l' I
futbolo	f U d b O 5 o:
fėjos	f' e: j o: s
gaila	g aI 5 a
galias	g a l' a s
galiausiai	g a l' aU s' aI
galimybes	g a l' I m' i: b' E s
galutinė	g a 5 U t' I n' e:
galvoję	g a 5 v o: j {:
galėjai	g a l' e: j aI
galėtų	g a l' e: t u:
gaminantys	g a m' I n a n' t' i: s
gaminti	g a m' I n' t' I
gamtos	g a m t o: s
gamtos	g a m t o: s
gandras	g a n d r a s
garbę	g a r' b' {:
gardžių	g a r' dZ' u:
garsi	g a r' s' I
garsina	g a r' s' I n a
gatve	g a t' v' E
gatvių	g A: t' v' u:
gatvės	g A: t' v' e: s
gatvėse	g A: t' v' e: s' E
gaujos	g aU j o: s
gaujos	g aU j o: s
gaunama	g aU n a m a
gaunama	g aU n a m a
gaunamos	g aU n a m o: s
gaunamos	g aU n a m o: s
gavo	g A: v o:
gebėjimą	g' E b' e: j I m A:
gegužių	g' E g U Z' u:
gegužių	g' E g U Z' u:
geizerių	g' EI z' E r' u:
geltona	g' E 5 t o: n a
genocidą	g' E n O ts' I d A:
gera	g' E r a
gera	g' {: r a
gerais	g' E r aI s
geram	g' E r a m
geram	g' E r a m
gerbėjai	g' E r' b' e: j aI
geriau	g' E r' aU
geriausios	g' E r' aU s' o: s
gerina	g' {: r' I n a
geros	g' E r o: s
geros	g' {: r o: s
gerą	g' {: r A:
gerųjų	g' E r u: j u:
gestų	g' E s t u:
giedrame	g' E d r a m' E
giltinė	g' I l' t' I n' e:
giltinė	g' I l' t' I n' e:
gimiau	g' I m' aU
giminaitis	g' I m' I n aI t' I s
giminė	g' I m' I n' e:
giminės	g' I m' I n' e: s
gimnazijos	g' I m n A: z' I j o: s
gintaras	g' I n t a r a s
ginčys	g' I n' tS' i: s
girdėtas	g' I r' d' e: t a s
gitara	g' I t a r a
gitara	g' I t A: r a
glaudžiai	g 5 aU dZ' aI
globalizaciją	g 5 O b a l' I z A: ts' I j A:
globėjas	g 5 o: b' e: j a s
grafiką	g r A: f' I k A:
gramatika	g r a m A: t' I k a
grandiozinio	g r a n' d' I j O z' I n' o:
gražiai	g r a Z' aI
gražiai	g r A: Z' aI
gražiausių	g r a Z' aU s' u:
gražus	g r a Z U s
gražų	g r A: Z u:
greitai	g r' EI t aI
greito	g r' EI t o:
greitosios	g r' EI t o: s' o: s
greitosios	g r' EI t o: s' o: s
greitį	g r' EI t' i:
greičiausias	g r' EI tS' aU s' a s
greičiu	g r' EI tS' U
griežtinimą	g r' Ie S' t' I n' I m A:
griežtinti	g r' Ie S' t' I n' t' I
groti	g r o: t' I
groti	g r o: t' I
grupė	g r U p' e:
grupėje	g r U p' e: j E
grybų	g r' i: b u:
grynojo	g r' i: n o: j o:
grynos	g r' i: n o: s
grynos	g r' i: n o: s
grynųjų	g r' i: n u: j u:
grįžau	g r' i: Z aU
grįžtantys	g r' i: S t a n' t' i: s
grįžęs	g r' i: Z' {: s
gulėjo	g U l' e: j o:
gydo	g' i: d o:
gydymo	g' i: d' i: m o:
gydymą	g' i: d' i: m A:
gydytojai	g' i: d' i: t o: j aI
gyvenant	g' i: v' {: n a n t
gyvendama	g' i: v' E n d a m a
gyvenimiški	g' i: v' {: n' I m' I S' k' I
gyventi	g' i: v' E n' t' I
gyvenvietes	g' i: v' E n' v' Ie t' E s
gyvuoja	g' i: v UO j a
gyvybė	g' i: v' i: b' e:
gyvybę	g' i: v' i: b' {:
gyvūną	g' i: v u: n A:
gyvų	g' i: v u:
gėrio	g' e: r' o:
hormono	G O r m O n o:
hostelis	G O s' t' E l' I s
humoro	G U m O r o:
idėjų	I d' e: j u:
ieškinių	j Ie S' k' I n' u:
iki	I k' I
ikiteisminis	I k' I t' EI s' m' I n' I s
ilgiau	I l' g' aU
ilgisi	I l' g' I s' I
ilgą	I 5 g A:
iliuziniai	I l' U z' I n' aI
importuotų	I m p O r t UO t u:
imt	I m t
imtynių	I m' t' i: n' u:
incidento	I n' ts' I d' E n t o:
incidentą	I n' ts' I d' E n t A:
individualybę	I n' d' I v' I d U a l' i: b' {:
infarkto	I n f a r k t o:
infliacija	I n' f' l' A: ts' I j a
infliaciją	I n' f' l' A: ts' I j A:
informaciją	I n f O r m A: ts' I j A:
informuosime	I n f O r m UO s' I m' E
iniciatyvi	I n' I ts' I j a t' i: v' I
inkstai	I n k s t aI
inspekcija	I n' s' p' E k ts' I j a
inspekcijos	I n' s' p' E k ts' I j o: s
inspektoriai	I n' s' p' E k t O r' aI
inspektoriams	I n' s' p' E k t O r' a m s
institucija	I n' s' t' I t U ts' I j a
institucijos	I n' s' t' I t U ts' I j o: s
institutas	I n' s' t' I t U t a s
instrumentas	I n s t r U m' E n t a s
insulto	I n s U 5 t o:
integruotos	I n' t' E g r UO t o: s
intelektualiosios	I n' t' E l' E k t U A: l' o: s' o: s
intelektualiosios	I n' t' E l' E k t U a l' o: s' o: s
intensyvumas	I n' t' E n' s' i: v U m a s
interesų	I n' t' E r' E s u:
internetą	I n' t' E r' n' E t A:
intervencijai	I n' t' E r' v' E n' ts' I j aI
intervencijos	I n' t' E r' v' E n' ts' I j o: s
intrigų	I n' t' r' I g u:
intuicija	I n t U I ts' I j a
investicijas	I n' v' E s' t' I ts' I j a s
investicijos	I n' v' E s' t' I ts' I j o: s
investuotojai	I n' v' E s t UO t o: j aI
irzlumą	I r z 5 U m A:
ispanų	I s p A: n u:
istoriją	I s t O r' I j A:
istorinis	I s t O r' I n' I s
istorinėmis	I s t O r' I n' e: m' I s
italų	I t A: 5 u:
išalkęs	I S a l' k' {: s
išbandymų	I Z b a n' d' i: m u:
išdavimo	I Z d a v' I m o:
išdavimą	I Z d a v' I m A:
išeitį	I S' EI t' i:
išgarsino	I Z g a r' s' I n o:
išgelbėjo	I Z' g' E l' b' e: j o:
išgelbėti	I Z' g' E l' b' e: t' I
išgyveno	I Z' g' i: v' {: n o:
iškelta	I S' k' E 5 t a
iškelta	I S' k' E 5 t a
iškepė	I S' k' E p' e:
iškrito	I S' k r' I t o:
iškritęs	I S' k r' I t' {: s
išleidžia	I S' l' EI dZ' a
išlikusios	I S' l' I k U s' o: s
išlipo	I S' l' I p o:
išlydima	I S' l' i: d' I m a
išlydima	I S' l' i: d' I m a
išmokau	I S m o: k aU
išmokti	I S m o: k t' I
išmokti	I S m o: k t' I
išnyko	I S' n' i: k o:
išpuoselėtas	I S p UO s' E l' e: t a s
išpūstas	I S p u: s t a s
išraiška	I S r aI S k a
išrinktąją	I S' r' I n k t A: j A:
išsamesnę	I s a m' E s' n' {:
išsamesnę	I S s a m' E s' n' {:
išsiveržimą	I S' s' I v' E r' Z' I m A:
išsiveržimą	I s' I v' E r' Z' I m A:
išskirtinius	I s' k' I r' t' I n' U s
išskirtinius	I S' s' k' I r' t' I n' U s
išspręsti	I s' p' r' {: s' t' I
išspręsti	I S' s' p' r' {: s' t' I
išteka	I S' t' E k a
ištikimas	I S' t' I k' I m a s
ištikimybės	I S' t' I k' I m' i: b' e: s
ištvermę	I S' t' v' E r' m' {:
išvaizda	I S v aI z d a
išvaizdai	I S v aI z d aI
išvažiavo	I S v a Z' A: v o:
išvedimo	I S' v' E d' I m o:
išvengti	I S' v' E n' k t' I
išverstas	I S' v' E r s t a s
išversti	I S' v' E r' s' t' I
išversti	I S' v' E r' s' t' I
išvis	I S' v' I s
išvydę	I S' v' i: d' {:
išvyka	I S' v' i: k a
išvys	I S' v' i: s
išėjusi	I S' e: j U s' I
ja	j a
jam	j a m
jame	j a m' E
japonas	j a p O n a s
japonų	j a p O n u:
jaunatvišku	j aU n A: t' v' I S k U
jaunesnę	j aU n' E s' n' {:
jaunieji	j aU n' Ie j I
jauniems	j aU n' Ie m s
jaunimas	j aU n' I m a s
jaunuoliui	j aU n UO l' Ui
jaunuolių	j aU n UO l' u:
jaunų	j aU n u:
jausmai	j aU s m aI
jausmas	j aU s m a s
jausmo	j aU s m o:
jausmą	j aU s m A:
jautrias	j aU t' r' a s
jodinėjo	j o: d' I n' e: j o:
jog	j o: k
jogos	j O g o: s
joja	j o: j a
joja	j o: j a
joje	j o: j E
jokia	j o: k' a
jokia	j o: k' a
jokio	j o: k' o:
jos	j o: s
jos	j o: s
jubiliejinis	j U b' I l' Ie j I n' I s
jubiliejus	j U b' I l' Ie j U s
jubiliejus	j U b' I l' Ie j U s
jubiliejų	j U b' I l' Ie j u:
jungia	j U n' g' a
juodosios	j UO d o: s' o: s
juodosios	j UO d o: s' o: s
juodą	j UO d A:
juokdario	j UO g d a r' o:
juos	j UO s
jį	j i:
jų	j u:
kada	k a d a
kadaise	k a d aI s' E
kaimo	k aI m o:
kaimynai	k aI m' i: n aI
kaina	k aI n a
kainas	k aI n a s
kainos	k aI n o: s
kainuoja	k aI n UO j a
kairiąja	k aI r' A: j a
kaita	k aI t a
kaita	k aI t a
kakavos	k a k A: v o: s
kalbinti	k a l' b' I n' t' I
kalbintų	k a l' b' I n t u:
kalboje	k a 5 b o: j E
kalbotyros	k a 5 b o: t' i: r o: s
kalbėdami	k a l' b' e: d a m' I
kalifato	k a l' I f A: t o:
kalnai	k a 5 n aI
kalnus	k a 5 n U s
kaltinimus	k a l' t' I n' I m U s
kaltinti	k a l' t' I n' t' I
kalvos	k a 5 v o: s
kalvos	k a 5 v o: s
kam	k a m
kamavusi	k a m A: v U s' I
kambario	k a m b a r' o:
kameros	k A: m' E r o: s
kandidatus	k a n' d' I d a t U s
kandidatus	k a n' d' I d A: t U s
kankina	k a n' k' I n a
kantrybę	k a n' t' r' i: b' {:
kapas	k A: p a s
kapitalizmo	k a p' I t a l' I z m o:
kapitone	k a p' I t o: n' E
karinei	k a r' I n' EI
kariniu	k a r' I n' U
kariniuose	k a r' I n' UO s' E
kariuomenės	k a r' UO m' E n' e: s
karių	k a r' u:
karjeros	k a r' j E r o: s
karo	k A: r o:
kartais	k a r t aI s
kartais	k a r t aI s
kartot	k a r t o: t
kartus	k a r t U s
kartus	k a r t U s
kartus	k a r t U s
karys	k a r' i: s
karštą	k a r S t A:
karščio	k a r' S' tS' o:
kasdienybės	k a z' d' Ie n' i: b' e: s
kasmet	k a s' m' E t
kasos	k a s o: s
kasos	k A: s o: s
katastrofas	k a t a s t r O f a s
kavinės	k a v' I n' e: s
kažkada	k a S k a d a
kažkoks	k a S k o: k s
keiksmažodį	k' EI k s m A: Z o: d' i:
keisti	k' EI s' t' I
keisti	k' EI s' t' I
keitimas	k' EI t' I m a s
keitė	k' EI t' e:
keičiasi	k' EI tS' a s' I
keleiviai	k' E l' EI v' aI
keletus	k' {: l' E t U s
keletą	k' {: l' E t A:
keli	k' E l' I
keli	k' {: l' I
keliauja	k' E l' aU j a
keliaujant	k' E l' aU j a n t
keliautojų	k' E l' aU t o: j u:
keliavo	k' E l' A: v o:
kelionėms	k' E l' o: n' e: m s
kelionės	k' E l' o: n' e: s
kelionę	k' E l' o: n' {:
keliui	k' {: l' Ui
kelią	k' {: l' A:
kelią	k' E l' A:
kelmuoti	k' E 5 m UO t' I
kenksmingų	k' E n' k s' m' I n g u:
kepta	k' E p t a
ketinama	k' E t' I n a m a
ketur	k' E t U r
keturiais	k' E t U r' aI s
keturiasdešimties	k' E t U r' a z' d' E S' I m' t' Ie s
keturiasdešimtųjų	k' E t U r' a z' d' E S' I m t u: j u:
keturiese	k' E t U r' Ie s' E
keturioliktoji	k' E t U r' o: l' I k t o: j I
keturioliktųjų	k' E t U r' o: l' I k t u: j u:
keturis	k' {: t U r' I s
keturviečiame	k' E t U r' v' Ie tS' a m' E
ketveriukę	k' E t' v' E r' U k' {:
ketvirtieji	k' E t' v' I r' t' Ie j I
ketvirtį	k' E t' v' I r' t' i:
ketvirtį	k' {: t' v' I r' t' i:
kešim	k' {: S' I m
kiantieji	k a n' t' Ie j I
kiekvienais	k' Ie k v' Ie n aI s
kiekvienam	k' Ie k v' Ie n a m
kiekvienam	k' Ie k v' Ie n a m
kiekvienoje	k' Ie k v' Ie n o: j E
kiekį	k' Ie k' i:
kiemelyje	k' E m' {: l' i: j E
kijos	k' I j o: s
kils	k' I 5 s
kilusi	k' I 5 U s' I
kinta	k' I n t a
kirpk	k' I r p k
kirčio	k' I r' tS' o:
kitame	k' I t a m' E
kiti	k' I t' I
kitiems	k' I t' Ie m s
kitoje	k' I t o: j E
kitokios	k' I t o: k' o: s
kitoks	k' I t o: k s
kitu	k' I t U
klaida	k 5 aI d a
klaidžioja	k 5 aI dZ' o: j a
klasikinės	k 5 a s' I k' I n' e: s
klausimais	k 5 aU s' I m aI s
klausimais	k 5 aU s' I m aI s
klausimas	k 5 aU s' I m a s
klausimu	k 5 aU s' I m U
klausimus	k 5 aU s' I m U s
klausimą	k 5 aU s' I m A:
klausydavosi	k 5 aU s' i: d a v o: s' I
klausyti	k 5 aU s' i: t' I
klausytis	k 5 aU s' i: t' I s
klientams	k l' I j E n t a m s
klimatas	k l' I m a t a s
klimato	k l' I m a t o:
klimatologė	k l' I m a t O 5 O g' e:
knygas	k n' i: g a s
koalicijos	k O a l' I ts' I j o: s
kokios	k o: k' o: s
kokios	k o: k' o: s
kokteilį	k O k t' EI l' i:
kolegos	k O l' E g o: s
kolekciją	k O l' E k ts' I j A:
komandoje	k O m a n d o: j E
komandą	k O m a n d A:
kombinacijas	k O m' b' I n A: ts' I j a s
komedijos	k O m' E d' I j o: s
komedijų	k O m' E d' I j u:
komisija	k O m' I s' I j a
kompanijų	k O m p A: n' I j u:
kompiuterinės	k O m' p' U t' E r' I n' e: s
kompiuterio	k O m' p' U t' E r' o:
kompleksas	k O m' p' l' E k s a s
kompleksas	k O m' p' l' E k s a s
komunikacija	k O m U n' I k A: ts' I j a
komunikacijos	k O m U n' I k A: ts' I j o: s
koncertais	k O n' ts' E r t aI s
koncertas	k O n' ts' E r t a s
kone	k o: n' E
konfiskavimo	k O n' f' I s k A: v' I m o:
konfliktą	k O n' f' l' I k t A:
konkrečias	k O n' k r' E tS' a s
konkursą	k O n k U r' s A:
konservatorių	k O n' s' E r v A: t O r' u:
kontakto	k O n t A: k t o:
kontrolei	k O n t r O l' EI
kortomis	k O r t o: m' I s
kosmopolitinį	k O s m O p O l' I t' I n' i:
kostiumą	k O s' t' U m A:
kostiumą	k O s' t' U m A:
kovingumą	k o: v' I n g U m A:
kovojo	k o: v o: j o:
kovos	k o: v o: s
kovos	k o: v o: s
kramsnojo	k r a m s n o: j o:
kraujagyslių	k r aU j A: g' i: s' l' u:
kraujospūdžio	k r aU j o: s p u: dZ' o:
kraštas	k r A: S t a s
krašto	k r A: S t o:
kraštovaizdžiai	k r a S t o: v aI Z' dZ' aI
kraštus	k r a S t U s
kremta	k r' E m t a
kremzlės	k r' E m' z' l' e: s
kremzlės	k r' E m' z' l' e: s
krepšininkai	k r' {: p' S' I n' I n k aI
krikščioniškas	k r' I k S' tS' o: n' I S k a s
krikščioniškų	k r' I k S' tS' o: n' I S k u:
kritusios	k r' I t U s' o: s
krizė	k r' I z' e:
krovinių	k r o: v' I n' u:
kruizas	k r U I z a s
krėsdami	k r' e: z d a m' I
krūmas	k r u: m a s
krūvas	k r u: v a s
krūvis	k r u: v' I s
kukurūzų	k U k U r u: z u:
kulinarijos	k U l' I n A: r' I j o: s
kulinarė	k U l' I n A: r' e:
kultūriniu	k U 5 t u: r' I n' U
kultūrinėmis	k U 5 t u: r' I n' e: m' I s
kultūroje	k U 5 t u: r o: j E
kultūros	k U 5 t u: r o: s
kultūrą	k U 5 t u: r A:
kunigaikštystei	k U n' I g aI k S' t' i: s' t' EI
kunigaikštystės	k U n' I g aI k S' t' i: s' t' e: s
kupranugaris	k U p r a n U g A: r' I s
kurias	k U r' a s
kurias	k U r' a s
kurie	k U r' Ie
kuriems	k U r' Ie m s
kurio	k U r' o:
kuriose	k U r' o: s' E
kuriuos	k U r' UO s
kuriuos	k U r' UO s
kurių	k U r' u:
kurortus	k U r O r t U s
kursuoti	k U r s UO t' I
kurtas	k U r t a s
kurčias	k U r' tS' a s
kurčias	k U r' tS' a s
kvantinės	k v a n' t' I n' e: s
kviečia	k v' Ie tS' a
kyla	k' i: 5 a
kūdikiai	k u: d' I k aI
kūnu	k u: n U
kūriniams	k u: r' I n' a m s
kūrinys	k u: r' I n' i: s
kūrybiškumas	k u: r' i: b' I S k U m a s
kūrė	k u: r' e:
kūrėjas	k u: r' e: j a s
labiau	5 a b' aU
laidų	5 aI d u:
laikais	5 aI k aI s
laikinas	5 aI k' I n a s
laiko	5 aI k o:
laikomos	5 aI k o: m o: s
laiku	5 aI k U
laikui	5 aI k Ui
laikytą	5 aI k' i: t A:
laisva	5 aI s v a
laisva	5 aI s v a
laisvos	5 aI s v o: s
laisvos	5 aI s v o: s
laisvos	5 aI s v o: s
laisvų	5 aI s v u:
laivas	5 aI v a s
laivų	5 aI v u:
langą	5 a n g A:
lanko	5 a n k o:
lankstumą	5 a n k s t U m A:
lankėmės	5 a n' k' e: m' e: s
lapais	5 A: p aI s
lapuočių	5 a p UO tS' u:
laukdamos	5 aU g d a m o: s
laukiama	5 aU k' a m a
laukiama	5 aU k' a m a
laukt	5 aU k t
laukuose	5 aU k UO s' E
lavašu	5 a v A: S U
lazdyno	5 a z' d' i: n o:
lazdynų	5 a z' d' i: n u:
lazerių	5 A: z' E r' u:
leidimo	l' EI d' I m o:
leido	l' EI d o:
leisti	l' EI s' t' I
leitenantė	l' EI t' E n a n' t' e:
lengviausia	l' E n' g v' aU s' a
lenkė	l' E n' k' e:
lenkė	l' E n' k' e:
lietus	l' Ie t U s
lietus	l' Ie t U s
lietus	l' Ie t U s
lietuvis	l' Ie t U v' I s
lietuviškas	l' Ie t U v' I S k a s
lietuviškos	l' Ie t U v' I S k o: s
ligomis	l' I g o: m' I s
ligoms	l' I g O m s
ligoniams	l' I g o: n' a m s
ligonių	l' I g o: n' u:
ligų	l' I g u:
liko	l' I k o:
lingvistai	l' I n' g v' I s t aI
linksmas	l' I n k s m a s
linksmas	l' I n k s m a s
linksmina	l' I n' k s' m' I n a
linkusi	l' I n k U s' I
lipo	l' I p o:
literatūrai	l' I t' E r a t u: r aI
liūtai	l' u: t aI
liūčių	l' u: tS' u:
liūčių	l' u: tS' u:
lopšines	5 o: p' S' I n' E s
lyderiais	l' i: d' E r' aI s
lydėjo	l' i: d' e: j o:
lygių	l' i: g' u:
lyties	l' i: t' Ie s
ląstelių	5 A: s' t' {: l' u:
lėipas	l' e: I p a s
lėktuvas	l' e: k t U v a s
lėktuvo	l' e: k t U v o:
lėkusi	l' e: k U s' I
lėšų	l' e: S u:
maistas	m aI s t a s
maistą	m aI s t A:
maltiečiai	m a l' t' Ie tS' aI
malšinantį	m a l' S' I n a n' t' i:
mama	m a m a
mama	m A: m a
mamos	m a m o: s
mamos	m A: m o: s
manau	m a n aU
mane	m a n' E
masina	m A: s' I n a
masinių	m A: s' I n' u:
matavosi	m a t A: v o: s' I
matiniai	m A: t' I n' aI
matmenyse	m a t' m' E n' i: s' E
mato	m A: t o:
matricų	m A: t' r' I ts u:
matė	m A: t' e:
mavosi	m A: v o: s' I
mačiau	m a tS' aU
mačą	m A: tS A:
mažesnę	m a Z' E s' n' {:
mažino	m A: Z' I n o:
mažinti	m A: Z' I n' t' I
mažėja	m a Z' e: j a
mažėjo	m a Z' e: j o:
mechanikas	m' E x A: n' I k a s
mechanizmo	m' E x a n' I z m o:
medicinoje	m' E d' I ts' I n o: j E
mediciną	m' E d' I ts' I n A:
mediena	m' E d' Ie n a
mediena	m' E d' Ie n a
mediko	m' E d' I k o:
medis	m' {: d' I s
meditacija	m' E d' I t A: ts' I j a
medus	m' E d U s
medyje	m' {: d' i: j E
medžiagų	m' {: dZ' a g u:
medžiagų	m' E dZ' a g u:
medžioklėje	m' E dZ' o: k l' e: j E
medžiotojai	m' E dZ' o: t o: j aI
megztuką	m' E k s t U k A:
meiles	m' EI l' E s
meistru	m' EI s t r U
melodija	m' E 5 O d' I j a
menas	m' {: n a s
menininkas	m' {: n' I n' I n k a s
menkiausių	m' E n' k' aU s' u:
menko	m' E n k o:
meno	m' {: n o:
mergaitė	m' E r g aI t' e:
mergaitės	m' E r g aI t' e: s
mergaitės	m' E r g aI t' e: s
merginos	m' E r' g' I n o: s
merginos	m' E r' g' I n o: s
merginų	m' E r' g' I n u:
mesti	m' E s' t' I
mesti	m' E s' t' I
metalų	m' E t A: 5 u:
metinį	m' {: t' I n' i:
metodus	m' E t O d U s
mečete	m' E tS' E t' E
mečete	m' E tS' E t' E
mečetė	m' E tS' E t' e:
mečetės	m' E tS' E t' e: s
miegas	m' Ie g a s
miegoti	m' Ie g o: t' I
miestas	m' Ie s t a s
mieste	m' Ie s' t' E
mieste	m' Ie s' t' E
miestelyje	m' Ie s' t' {: l' i: j E
miestelį	m' Ie s' t' {: l' i:
miestiečiai	m' Ie s' t' Ie tS' aI
miestu	m' Ie s t U
migracijos	m' I g r A: ts' I j o: s
milijonų	m' I l' I j o: n u:
milžiniška	m' I l' Z' I n' I S k a
milžinišką	m' I l' Z' I n' I S k A:
ministrui	m' I n' I s t r Ui
minią	m' I n' A:
mintis	m' I n' t' I s
mintis	m' I n' t' I s
mintys	m' I n' t' i: s
minės	m' I n' e: s
mirgėjo	m' I r' g' e: j o:
mirti	m' I r' t' I
mirtį	m' I r' t' i:
misija	m' I s' I j a
mitologinį	m' I t O 5 O g' I n' i:
miškams	m' I S k a m s
miškelyje	m' I S' k' {: l' i: j E
miško	m' I S k o:
mišriųjį	m' I S' r' u: j i:
mobiliojo	m O b' I l' o: j o:
mobiliųjų	m O b' I l' u: j u:
modelius	m O d' E l' U s
modelių	m O d' E l' u:
moderniai	m O d' E r' n' aI
moderniai	m O d' E r' n' aI
moderniųjų	m O d' E r' n' u: j u:
modernus	m O d' E r n U s
mokamas	m o: k a m a s
mokestį	m o: k' E s' t' i:
mokesčio	m o: k' E S' tS' o:
mokslas	m o: k s 5 a s
moksleivių	m o: k s' l' EI v' u:
mokslininkas	m o: k s' l' I n' I n k a s
mokslus	m o: k s 5 U s
mokslus	m o: k s 5 U s
mokslų	m o: k s 5 u:
mokykla	m o: k' i: k 5 a
mokykla	m o: k' i: k 5 a
mokyklinių	m o: k' i: k l' I n' u:
mokyklos	m o: k' i: k 5 o: s
mokyklą	m o: k' i: k 5 A:
mokymo	m o: k' i: m o:
mokymui	m o: k' i: m Ui
mokytojams	m o: k' i: t o: j a m s
mokytojas	m o: k' i: t o: j a s
mokytojau	m o: k' i: t o: j aU
moteriai	m o: t' E r' aI
moteriškų	m o: t' E r' I S k u:
motociklams	m O t O ts' I k 5 a m s
motyvuoti	m O t' i: v UO t' I
močiutė	m o: tS' U t' e:
mugėje	m U g' e: j E
muitų	m Ui t u:
mums	m U m s
musulmonų	m U s U 5 m O n u:
musulmonų	m U s U 5 m o: n u:
muziejų	m U z' Ie j u:
muzikantai	m U z' I k a n t aI
muzikantas	m U z' I k a n t a s
mušti	m U S' t' I
mušti	m U S' t' I
mylimas	m' i: l' I m a s
mylimas	m' i: l' I m a s
mėgo	m' e: g o:
mėgsta	m' e: k s t a
mėgstamiausias	m' e: k s t a m' aU s' a s
mėgstu	m' e: k s t U
mėgėjai	m' e: g' e: j aI
mėnesis	m' e: n' E s' I s
mėnesius	m' e: n' E s' U s
mėnesių	m' e: n' E s' u:
mėsinė	m' e: s' I n' e:
mėsinė	m' e: s' I n' e:
nacionaliniai	n a ts' I j O n A: l' I n' aI
nacionaliniame	n a ts' I j O n A: l' I n' a m' E
nacionalizmo	n a ts' I j O n a l' I z m o:
naftos	n A: f t o: s
nagrinėjo	n a g r' I n' e: j o:
nagu	n a g U
naktimis	n a k t' I m' I s
namai	n a m aI
namie	n a m' Ie
namui	n A: m Ui
nare	n a r' E
nare	n A: r' E
narkotikų	n a r k O t' I k u:
natūraliai	n a t u: r A: l' aI
natūraliai	n a t u: r a l' aI
natūralios	n a t u: r A: l' o: s
natūralios	n a t u: r a l' o: s
naudingos	n aU d' I n g o: s
naudoja	n aU d o: j a
naudojama	n aU d o: j a m a
naudojami	n aU d o: j a m' I
naudojamų	n aU d o: j a m u:
naudojant	n aU d o: j a n t
naudojimo	n aU d o: j I m o:
naudosis	n aU d o: s' I s
naudoti	n aU d o: t' I
naujajai	n aU j a j aI
naujajam	n aU j A: j a m
naujajam	n aU j A: j a m
naujos	n aU j o: s
naujos	n aU j o: s
naujųjų	n aU j u: j u:
našta	n a S t a
našta	n A: S t a
neaišku	n' E aI S k U
neaiškus	n' E aI S k U s
neaktyvumas	n' E a k t' i: v U m a s
nealkoholinį	n' E a 5 k O G O l' I n' i:
neatitikimą	n' E a t' I t' I k' I m A:
nebegalėdavo	n' E b' E g a l' e: d a v o:
nebepamatysiu	n' E b' E p a m a t' i: s' U
nebesinori	n' E b' E s' I n o: r' I
nebuvo	n' E b U v o:
nedalyvaus	n' E d a l' i: v aU s
nedarę	n' E d A: r' {:
nedemonstruoti	n' E d' E m O n s t r UO t' I
nedidelius	n' E d' I d' E l' U s
neetiška	n' E E t' I S k a
negalima	n' E g A: l' I m a
negalią	n' {: g a l' A:
negalėjome	n' E g a l' e: j o: m' E
negalės	n' E g a l' e: s
negalės	n' {: g a l' e: s
negalėtume	n' E g a l' e: t U m' E
negalėtumėte	n' E g a l' e: t U m' e: t' E
negalėčiau	n' E g a l' e: tS' aU
negana	n' E g a n a
negarantuoja	n' E g a r a n t UO j a
negerbia	n' E g' E r' b' a
negerbia	n' E g' E r' b' a
negu	n' E g U
neigia	n' EI g' a
neišsemiamas	n' E I s' E m' a m a s
neišsemiamas	n' E I s' E m' a m a s
neišsemiamas	n' E I S' s' E m' a m a s
neišsemiamas	n' E I S' s' E m' a m a s
neišsprendžia	n' E I s' p' r' E n' dZ' a
neišsprendžia	n' E I S' s' p' r' E n' dZ' a
nejaučia	n' E j aU tS' a
nejaučia	n' E j aU tS' a
nekainuoja	n' E k aI n UO j a
nekeista	n' E k' EI s t a
nekeista	n' E k' EI s t a
nekeista	n' E k' EI s t a
nekeisti	n' E k' EI s' t' I
nekeisti	n' E k' EI s' t' I
nekito	n' E k' I t o:
neklauso	n' E k 5 aU s o:
neklaužada	n' E k 5 aU Z a d a
nekokią	n' E k o: k' A:
nekomentavo	n' E k O m' E n t A: v o:
nelaimingų	n' E 5 aI m' I n g u:
nelengva	n' E l' E n g v a
nelengva	n' E l' E n g v a
nelengvą	n' E l' E n g v A:
nemaži	n' E m a Z' I
nemoka	n' E m o: k a
nemoku	n' E m o: k U
nemoku	n' E m o: k U
nemėginkite	n' E m' e: g' I n' k' I t' E
nepaisant	n' E p aI s a n t
nepaliauja	n' E p a l' aU j a
nepasiekia	n' E p a s' Ie k' a
nepasiekia	n' E p a s' Ie k' a
nepasižymi	n' E p a s' I Z' i: m' I
nepasižymi	n' E p a s' I Z' i: m' I
nepilnametis	n' E p' I 5 n a m' {: t' I s
nepilnamečiams	n' E p' I 5 n a m' {: tS' a m s
nepjauna	n' E p' j aU n a
neplanuoja	n' E p 5 a n UO j a
nepraleidžiančiu	n' E p r a l' EI dZ' a n' tS' U
nepretenduotų	n' E p' r' E t' E n d UO t u:
nepripažįsta	n' E p' r' I p a Z' i: s t a
nepritariamas	n' E p' r' I t a r' a m a s
neprofesionalūs	n' E p r o: f' E s' I j O n A: 5 u: s
neproporcingai	n' E p r O p O r' ts' I n g aI
nerasdamas	n' E r a z d a m a s
nerimsta	n' E r' I m s t a
nerimą	n' {: r' I m A:
nertinius	n' E r' t' I n' U s
nesibaigė	n' E s' I b aI g' e:
nesitikėjau	n' E s' I t' I k' e: j aU
nesiūlo	n' E s' u: 5 o:
neskolingi	n' E s k o: l' I n' g' I
neslėpė	n' E s' l' e: p' e:
nesmarkiai	n' E s m a r' k' aI
nespėsiu	n' E s' p' e: s' U
nesumokėtą	n' E s U m o: k' e: t A:
nesusikalbėjimas	n' E s U s' I k a l' b' e: j I m a s
nesutinka	n' E s U t' I n k a
nesėkminga	n' E s' e: k m' I n g a
nesėkmę	n' {: s' e: k m' {:
netaisyklingas	n' E t aI s' i: k l' I n g a s
netekimo	n' E t' E k' I m o:
netoli	n' E t o: l' I
netoliese	n' E t o: l' Ie s' E
neturėjome	n' E t U r' e: j o: m' E
netvirtas	n' E t' v' I r t a s
netvirtas	n' E t' v' I r t a s
neurozes	n' EU r O z' E s
neutralizuoti	n' EU t r a l' I z UO t' I
neužkrečiamoms	n' E U S' k r' E tS' a m O m s
neužkrėstų	n' E U S' k r' e: s t u:
nevarvėtų	n' E v a r' v' e: t u:
niasdešimt	n' a z' d' {: S' I m t
nieko	n' Ie k o:
niokotojus	n' o: k o: t o: j U s
nol	n O 5
nori	n o: r' I
nori	n o: r' I
norimo	n o: r' I m o:
norint	n o: r' I n t
noriu	n o: r' U
normos	n O r m o: s
norėjo	n o: r' e: j o:
nu	n U
nudzigseno	n U dz' I k s' {: n o:
nudžabalino	n U dZ a b A: l' I n o:
nudžiobijo	n U dZ' O b' I j o:
nufotografuoti	n U f O t O g r a f UO t' I
nukentėjo	n U k' E n' t' e: j o:
nukraujavę	n U k r aU j A: v' {:
numalšinti	n U m a l' S' I n' t' I
numerį	n U m' E r' i:
nuodingi	n UO d' I n' g' I
nuolaidų	n UO 5 aI d u:
nuolaidų	n UO 5 aI d u:
nuomone	n UO m o: n' E
nuomos	n UO m o: s
nuosekliai	n UO s' E k l' aI
nuostabi	n UO s t a b' I
nuostabiai	n UO s t a b' aI
nuostabiai	n UO s t A: b' aI
nuotaikos	n UO t aI k o: s
nuotrauka	n UO t r aU k a
nuotraukoje	n UO t r aU k o: j E
nuotrauką	n UO t r aU k A:
nuovadą	n UO v a d A:
nuoširdžias	n UO S' I r' dZ' a s
nupirko	n U p' I r k o:
nupirkti	n U p' I r' k t' I
nurodė	n U r o: d' e:
nusiaubė	n U s' aU b' e:
nusifotografavusi	n U s' I f O t O g r a f A: v U s' I
nusikaltėlius	n U s' I k a l' t' e: l' U s
nusikaltėlių	n U s' I k a l' t' e: l' u:
nusileidus	n U s' I l' EI d U s
nusiraminimo	n U s' I r a m' I n' I m o:
nusiteikę	n U s' I t' EI k' {:
nusiteikęs	n U s' I t' EI k' {: s
nusiuntusiai	n U s' U n t U s' aI
nuslepiama	n U s' l' E p' a m a
nuslepiama	n U s' l' E p' a m a
nusprendžia	n U s' p' r' E n' dZ' a
nustatyta	n U s t a t' i: t a
nustatė	n U s t A: t' e:
nustojau	n U s t o: j aU
nutartimi	n U t a r' t' I m' I
nutarė	n U t a r' e:
nutrauks	n U t r aU k s
nutukims	n U t U k' I m s
nuvažiuoti	n U v a Z' UO t' I
nuėjau	n U e: j aU
nuėjo	n U e: j o:
nykščio	n' i: k S' tS' o:
nė	n' e:
odontologiją	O d O n t O 5 O g' I j A:
oficialios	O f' I ts' I j A: l' o: s
oficialios	O f' I ts' I j a l' o: s
okupacija	O k U p A: ts' I j a
okupacinės	O k U p A: ts' I n' e: s
operacijų	O p' E r A: ts' I j u:
orchidėja	O r' x' I d' e: j a
organizacijas	O r g a n' I z A: ts' I j a s
organizaciją	O r g a n' I z A: ts' I j A:
organizme	O r g a n' I z' m' E
organizmo	O r g a n' I z m o:
organizmą	O r g a n' I z m A:
organizmų	O r g a n' I z m u:
organizuojamas	O r g a n' I z UO j a m a s
organizuojamos	O r g a n' I z UO j a m o: s
organizuota	O r g a n' I z UO t a
orų	o: r u:
orų	o: r u:
ot	O t
paaugliai	p a aU g l' aI
paaugliams	p a aU g l' a m s
paaugę	p a aU g' {:
pabaigos	p a b aI g o: s
pabaigos	p A: b aI g o: s
pabaigą	p A: b aI g A:
padargai	p a d a r g aI
padavė	p a d a v' e:
padidėja	p a d' I d' e: j a
padiktuota	p a d' I k t UO t a
padėti	p a d' e: t' I
pagalbos	p a g a 5 b o: s
pagaliau	p a g a l' aU
pagaląsti	p a g a 5 A: s' t' I
pagaląsti	p a g a 5 A: s' t' I
pagamintas	p a g a m' I n t a s
pagreitinti	p a g r' EI t' I n' t' I
pagrindai	p a g r' I n d aI
pagrindas	p A: g r' I n d a s
pagrindinių	p a g r' I n' d' I n' u:
pagrindinės	p a g r' I n' d' I n' e: s
paieškų	p a j Ie S k u:
pajamų	p a j a m u:
pajunta	p a j U n t a
pajėgiausios	p a j e: g' aU s' o: s
pajėgos	p A: j e: g o: s
pajėgų	p a j e: g u:
pajėgų	p a j e: g u:
pakabintas	p a k a b' I n t a s
pakaitalas	p A: k aI t a 5 a s
pakaktų	p a k a k t u:
pakantesni	p a k a n' t' E s' n' I
pakeitimas	p a k' EI t' I m a s
pakilti	p a k' I l' t' I
paklausios	p a k 5 aU s' o: s
paklausios	p a k 5 aU s' o: s
pakoniškumo	p a k o: n' I S k U m o:
pakoregavo	p a k O r' E g A: v o:
pakrantę	p a k r a n' t' {:
pakvietė	p a k v' Ie t' e:
palaidinę	p a 5 aI d' I n' {:
palaikymo	p a 5 aI k' i: m o:
palankios	p a 5 a n' k' o: s
palankios	p a 5 a n' k' o: s
palei	p a l' EI
palei	p A: l' EI
palieka	p a l' Ie k a
paliko	p a l' I k o:
palydove	p a l' i: d o: v' E
palydovo	p a l' i: d o: v o:
palūkanų	p a 5 u: k a n u:
pamaldos	p A: m a 5 d o: s
pamatysite	p a m a t' i: s' I t' E
pamatyti	p a m a t' i: t' I
pamačiau	p a m a tS' aU
pamačius	p a m A: tS' U s
pamažu	p a m a Z U
pamesti	p a m' E s' t' I
pamesti	p a m' E s' t' I
pamilau	p a m' I 5 aU
paminėta	p a m' I n' e: t a
pamokas	p A: m o: k a s
pamušalu	p A: m U S a 5 U
pamėgau	p a m' e: g aU
panaudoja	p a n aU d o: j a
panaši	p a n a S' I
papasakotos	p a p A: s a k o: t o: s
papročius	p A: p r o: tS' U s
parašo	p a r A: S o:
parašo	p A: r a S o:
parašytai	p a r a S' i: t aI
pardavimas	p a r d a v' I m a s
pardavimą	p a r d a v' I m A:
pardavė	p a r d a v' e:
parduotus	p a r d UO t U s
parduotuvė	p a r d UO t U v' e:
parduotuvėje	p a r d UO t U v' e: j E
parduotuvės	p a r d UO t U v' e: s
parduotuvę	p a r d UO t U v' {:
pardzagnojau	p a r dz a g n o: j aU
pareigas	p A: r' EI g a s
pareigingas	p a r' EI g' I n g a s
pareigūnai	p a r' EI g u: n aI
pareigūnais	p a r' EI g u: n aI s
pareigų	p a r' EI g u:
paremta	p a r' E m t a
paremta	p a r' E m t a
parenkami	p a r' E n k a m' I
parlamentaras	p a r 5 a m' E n t A: r a s
parlamentas	p a r 5 a m' E n t a s
parsitraukti	p a r' s' I t r aU k t' I
partija	p a r' t' I j a
partijos	p a r' t' I j o: s
partneriai	p a r' t' n' E r' aI
pasak	p a s a k
pasakojama	p A: s a k o: j a m a
pasakyti	p a s a k' i: t' I
pasakytą	p a s a k' i: t A:
pasauliniams	p a s aU l' I n' a m s
pasauly	p a s aU l' i:
pasaulėjauta	p a s aU l' e: j aU t a
pasaulėvaizdyje	p a s aU l' e: v aI z' d' i: j E
pasidarė	p a s' I d A: r' e:
pasididžiavimas	p a s' I d' I dZ' A: v' I m a s
pasidomėję	p a s' I d o: m' e: j {:
pasiekti	p a s' Ie k t' I
pasiekti	p a s' Ie k t' I
pasiekė	p a s' Ie k' e:
pasiilgsta	p a s' I I 5 k s t a
pasijust	p a s' I j U s t
pasinaudoti	p a s' I n aU d o: t' I
pasipuošusi	p a s' I p UO S U s' I
pasirašyti	p a s' I r a S' i: t' I
pasireikšti	p a s' I r' EI k S' t' I
pasirenka	p a s' I r' E n k a
pasirinkimas	p a s' I r' I n' k' I m a s
pasirinko	p a s' I r' I n k o:
pasirinkome	p a s' I r' I n k o: m' E
pasitikėjimo	p a s' I t' I k' e: j I m o:
pasiunčiau	p a s' U n' tS' aU
pasiūlymo	p a s' u: l' i: m o:
paskaitoje	p a s k aI t o: j E
paskaitų	p a s k aI t u:
paskaičiuota	p a s k aI tS' UO t a
paskatinimas	p a s k A: t' I n' I m a s
paskelbė	p a s' k' E l' b' e:
paskendusią	p a s' k' E n d U s' A:
paskleidžiama	p a s' k l' EI dZ' a m a
paskleidžiama	p a s' k l' EI dZ' a m a
paskutiniaisiais	p a s k U t' I n' aI s' aI s
paslaptį	p A: s 5 a p' t' i:
paslauga	p a s 5 aU g a
paslauga	p A: s 5 aU g a
paslaugas	p A: s 5 aU g a s
paslaugos	p A: s 5 aU g o: s
paslaugos	p a s 5 aU g o: s
paslaugų	p a s 5 aU g u:
paslaugų	p a s 5 aU g u:
paslepia	p a s' l' E p' a
paspartino	p a s p a r' t' I n o:
pastangomis	p a s t a n g o: m' I s
pastangų	p a s t a n g u:
pastaruosius	p a s t a r UO s' U s
pastate	p a s t a t' E
pastate	p A: s t a t' E
pastato	p A: s t a t o:
pastato	p a s t A: t o:
pastebėjo	p a s' t' E b' e: j o:
pastebėjęs	p a s' t' E b' e: j {: s
pastebėti	p a s' t' E b' e: t' I
pastovi	p a s t o: v' I
pastovi	p a s t o: v' I
pastovus	p a s t o: v U s
pasvajoti	p a s v a j o: t' I
pataikiau	p a t aI k' aU
patalpų	p a t a 5 p u:
pataria	p a t a r' a
patariama	p a t a r' a m a
patariama	p a t a r' a m a
pateikimas	p a t' EI k' I m a s
pateiks	p a t' EI k s
pateikta	p a t' EI k t a
pateikta	p a t' EI k t a
pateikti	p a t' EI k t' I
pateikti	p a t' EI k t' I
patiekalas	p A: t' Ie k a 5 a s
patiekalas	p a t' Ie k a 5 a s
patikrinti	p a t' I k r' I n' t' I
patinka	p a t' I n k a
patirtis	p a t' I r' t' I s
patirtis	p A: t' I r' t' I s
patogius	p a t o: g' U s
patriotizmas	p a t' r' I j O t' I z m a s
pats	p a t s
patvirtintas	p a t' v' I r' t' I n t a s
patyrusi	p a t' i: r U s' I
patyrusių	p a t' i: r U s' u:
patyčių	p a t' i: tS' u:
paukštį	p aU k S' t' i:
paukščiai	p aU k S' tS' aI
pavadinimus	p a v a d' I n' I m U s
pavarde	p A: v a r' d' E
pavasario	p a v A: s a r' o:
paveikti	p a v' EI k t' I
paveikti	p a v' EI k t' I
paveldu	p A: v' E 5 d U
pavestos	p a v' E s t o: s
pavestos	p a v' E s t o: s
paviršių	p a v' I r' S' u:
pavojingai	p a v o: j I n g aI
pavydėti	p a v' i: d' e: t' I
pavyks	p a v' i: k s
pačias	p a tS' a s
pačioje	p a tS' o: j E
pačių	p a tS' u:
paėmė	p a e: m' e:
pašalinimą	p a S A: l' I n' I m A:
pašalpos	p A: S a 5 p o: s
pašalpos	p a S a 5 p o: s
pašalpų	p a S a 5 p u:
pašto	p A: S t o:
pažadas	p A: Z a d a s
pažaisti	p a Z aI s' t' I
pažaisti	p a Z aI s' t' I
pažangia	p a Z a n' g' a
pažindamas	p a Z' I n d a m a s
pažinimas	p a Z' I n' I m a s
pažinimo	p a Z' I n' I m o:
pažymėjimų	p a Z' i: m' e: j I m u:
pažįstamų	p a Z' i: s t a m u:
pažįstamų	p a Z' i: s t a m u:
pelno	p' E 5 n o:
pelną	p' E 5 n A:
pelė	p' E l' e:
penkdešimt	p' E n' g d' E S' I m t
penkerius	p' E n' k' E r' U s
penkiasdešimties	p' E n' k' a z' d' E S' I m' t' Ie s
penkiasdešimties	p' E n' k' a z' d' E S' I m' t' Ie s
penkiasdešimtų	p' E n' k' a z' d' {: S' I m t u:
penkiasdešimtų	p' E n' k' a z' d' E S' I m t u:
penkiolikos	p' E n' k' o: l' I k o: s
penkioliktą	p' E n' k' o: l' I k t A:
penkioliktųjų	p' E n' k' o: l' I k t u: j u:
penkis	p' E n' k' I s
penktadieniais	p' E n k t A: d' Ie n' aI s
penktadienio	p' E n k t A: d' Ie n' o:
penktais	p' E n k t aI s
penktieji	p' E n' k t' Ie j I
penkto	p' E n k t o:
penktoji	p' E n k t o: j I
penktą	p' E n k t A:
pentinai	p' E n' t' I n aI
pentinais	p' E n' t' I n aI s
perima	p' E r' I m a
perlenk	p' E r' l' E n k
permainų	p' E r m aI n u:
personalas	p' E r s O n A: 5 a s
perspėja	p' E r' s' p' e: j a
pertvarkant	p' E r t v a r k a n t
pervestas	p' E r' v' E s t a s
perėjo	p' E r' e: j o:
perėjo	p' E r' e: j o:
peršantis	p' E r S a n' t' I s
pienas	p' Ie n a s
pieninių	p' Ie n' I n' u:
pienišką	p' Ie n' I S k A:
pievų	p' Ie v u:
piešiami	p' Ie S' a m' I
pigaus	p' I g aU s
pigiau	p' I g' aU
pigiausių	p' I g' aU s' u:
pikta	p' I k t a
pikta	p' I k t a
piktais	p' I k t aI s
piktnaudžiavimo	p' I k t n aU dZ' A: v' I m o:
pilies	p' I l' Ie s
pilietis	p' I l' Ie t' I s
pilną	p' I 5 n A:
piritas	p' I r' I t a s
pirktą	p' I r k t A:
pirmadienio	p' I r m A: d' Ie n' o:
pirmadienį	p' I r m A: d' Ie n' i:
pirmagimis	p' I r m A: g' I m' I s
pirmais	p' I r m aI s
pirmalaikiai	p' I r m a 5 aI k' aI
pirmas	p' I r m a s
pirmas	p' I r m a s
pirmenybėse	p' I r' m' E n' i: b' e: s' E
pirmiausia	p' I r' m' aU s' a
pirmininkas	p' I r' m' I n' I n k a s
pirmininkaus	p' I r' m' I n' I n k aU s
pirštų	p' I r S t u:
pirštų	p' I r S t u:
pjausim	p' j aU s' I m
pjautynių	p' j aU t' i: n' u:
planams	p 5 a n a m s
planas	p 5 A: n a s
planetos	p 5 a n' E t o: s
planui	p 5 A: n Ui
planuoja	p 5 a n UO j a
platesnį	p 5 a t' E s' n' i:
plačiai	p 5 a tS' aI
plačiai	p 5 A: tS' aI
pliki	p' l' I k' I
pliki	p' l' I k' I
plytelė	p' l' i: t' {: l' e:
plėstis	p' l' e: s' t' I s
plėtojama	p' l' e: t o: j a m a
plėtotei	p' l' e: t o: t' EI
poilsinių	p o: I l' s' I n' u:
poilsiui	p o: I l' s' Ui
pokyčių	p o: k' i: tS' u:
policininkus	p O l' I ts' I n' I n k U s
polisacharidų	p O l' I s a x a r' I d u:
politika	p O l' I t' I k a
politikai	p O l' I t' I k aI
politikas	p O l' I t' I k a s
politinės	p O l' I t' I n' e: s
politinę	p O l' I t' I n' {:
pomėgius	p o: m' e: g' U s
populiari	p O p U l' a r' I
populiariausia	p O p U l' a r aU s' a
populiariausias	p O p U l' a r aU s' a s
populiariausios	p O p U l' a r aU s' o: s
populiariausių	p O p U l' a r aU s' u:
populiarios	p O p U l' a r' o: s
populiarios	p O p U l' A: r' o: s
populiaru	p O p U l' a r U
populiarumą	p O p U l' a r U m A:
pora	p o: r a
pora	p o: r a
porai	p O r aI
porai	p o: r aI
poreikis	p o: r' EI k' I s
povas	p o: v a s
poveikį	p o: v' EI k' i:
pozicijoje	p O z' I ts' I j o: j E
pozicijos	p O z' I ts' I j o: s
poziciją	p O z' I ts' I j A:
pozityvios	p O z' I t' i: v' o: s
pozityvios	p O z' I t' i: v' o: s
prabangiais	p r a b a n' g' aI s
pradeda	p r a d' E d a
pradedu	p r a d' E d U
pradinę	p r a d' I n' {:
pradėjau	p r a d' e: j aU
pradėta	p r a d' e: t a
pradėta	p r a d' e: t a
pradžios	p r a dZ' o: s
pradžių	p r a dZ' u:
praklausiau	p r a k 5 aU s' aU
praktiniam	p r A: k t' I n' a m
praktiškai	p r A: k t' I S k aI
praleidžia	p r a l' EI dZ' a
praleidžiame	p r a l' EI dZ' a m' E
pramogos	p r A: m o: g o: s
pramogos	p r a m o: g o: s
pramogų	p r a m o: g u:
pramone	p r A: m o: n' E
prancūziška	p r a n ts u: z' I S k a
pranešimo	p r a n' E S' I m o:
pranešimą	p r a n' E S' I m A:
prapliupęs	p r a p' l' U p' {: s
praradimas	p r a r a d' I m a s
prasideda	p r a s' I d' E d a
prasidėjo	p r a s' I d' e: j o:
pratimų	p r a t' I m u:
praėjusio	p r a e: j U s' o:
praėjusių	p r a e: j U s' u:
prašneko	p r a S' n' {: k o:
prašom	p r A: S O m
prašyti	p r a S' i: t' I
prašytojas	p r a S' i: t o: j a s
prekiniams	p' r' {: k' I n' a m s
prekių	p' r' {: k' u:
prekyba	p' r' E k' i: b a
prekybos	p' r' E k' i: b o: s
prekės	p' r' {: k' e: s
premjero	p' r' E m' j E r o:
priebalsių	p' r' Ie b a l' s' u:
priedus	p' r' Ie d U s
priedus	p' r' Ie d U s
priedų	p' r' Ie d u:
priekaištų	p' r' Ie k aI S t u:
priemones	p' r' Ie m o: n' E s
priemonė	p' r' Ie m o: n' e:
priemonę	p' r' Ie m o: n' {:
priešlaikinio	p' r' Ie S 5 aI k' I n' o:
priešlaikinio	p' r' Ie S 5 aI k' I n' o:
priežiūros	p' r' Ie Z' u: r o: s
prigimtinės	p' r' I g' I m' t' I n' e: s
priimtina	p' r' I I m' t' I n a
priimtina	p' r' I I m' t' I n a
priklausė	p' r' I k 5 aU s' e:
prilygsta	p' r' I l' i: k s t a
prirašius	p' r' I r A: S' U s
pririšdavo	p' r' I r' I Z d a v o:
pririšo	p' r' I r' I S o:
pririšti	p' r' I r' I S' t' I
pririšti	p' r' I r' I S' t' I
prisiskambinti	p' r' I s' I s k a m' b' I n' t' I
prisistatęs	p' r' I s' I s t A: t' {: s
priskiriama	p' r' I s' k' I r' a m a
priskiriama	p' r' I s' k' I r' a m a
priskiriamas	p' r' I s' k' I r' a m a s
priskiriamas	p' r' I s' k' I r' a m a s
pritarti	p' r' I t a r' t' I
pritarti	p' r' I t a r' t' I
pritrauksiantis	p' r' I t r aU k s' a n' t' I s
privalo	p' r' I v A: 5 o:
privalomas	p' r' I v A: 5 o: m a s
privatumą	p' r' I v a t U m A:
privačiose	p' r' I v a tS' o: s' E
privačiose	p' r' I v a tS' o: s' E
privačią	p' r' I v A: tS' A:
priverstinių	p' r' I v' E r' s' t' I n' u:
priėmimas	p' r' I e: m' I m a s
pro	p r o:
probiotikus	p r O b' I j O t' I k U s
problema	p r O b' l' E m a
problemos	p r O b' l' E m o: s
problemą	p r O b' l' E m A:
procesui	p r O ts' E s Ui
produktai	p r O d U k t aI
produktai	p r O d U k t aI
produktas	p r O d U k t a s
profesija	p r O f' E s' I j a
profesiją	p r O f' E s' I j A:
profesionalams	p r O f' E s' O n A: 5 a m s
profesionali	p r O f' E s' O n a l' I
profesionalios	p r O f' E s' O n a l' o: s
profesionalios	p r O f' E s' O n A: l' o: s
profesionalumas	p r O f' E s' O n a 5 U m a s
profesoriau	p r O f' E s' O r' aU
profilaktinė	p r O f' I 5 A: k t' I n' e:
profsąjungos	p r O f s A: j U n g o: s
prognozes	p r O g n O z' E s
prognozuoja	p r O g n O z UO j a
progomis	p r o: g o: m' I s
programos	p r O g r A: m o: s
projektai	p r O j E k t aI
projektai	p r O j E k t aI
projektui	p r O j E k t Ui
projektui	p r O j E k t Ui
projektą	p r O j E k t A:
protestų	p r O t' E s t u:
proto	p r o: t o:
protrūkis	p r o: t r u: k' I s
provincijų	p r O v' I n' ts' I j u:
psichinio	p' s' I x' I n' o:
psichologija	p' s' I x O 5 O g' I j a
psichologijos	p' s' I x O 5 O g' I j o: s
psichologu	p' s' I x O 5 O g U
psichologu	p' s' I x O 5 O g U
psichoterapeutas	p' s' I x O t' E r a p' EU t a s
publicistiniuose	p U b' l' I ts' I s' t' I n' UO s' E
publika	p U b' l' I k a
puiki	p Ui k' I
puikų	p Ui k u:
pulionis	p U l' o: n' I s
pultelį	p U l' t' {: l' i:
punkto	p U n k t o:
punkto	p U n k t o:
puodas	p UO d a s
puola	p UO 5 a
puse	p U s' E
puse	p U s' E
pusių	p U s' u:
pusėmis	p U s' e: m' I s
pyragą	p' i: r A: g A:
pėstininkais	p' e: s' t' I n' I n k aI s
pėsčias	p' e: S' tS' a s
pūkinė	p u: k' I n' e:
pūkų	p u: k u:
racione	r a ts' I j O n' E
racione	r a ts' I j O n' E
radijas	r A: d' I j a s
radome	r A: d o: m' E
ragana	r A: g a n a
raidai	r aI d aI
rajonus	r a j O n U s
rajoną	r a j O n A:
ramiai	r a m' aI
ramiai	r A: m' aI
rango	r a n g o:
rango	r a n g o:
rankos	r a n k o: s
ranką	r a n k A:
rankų	r a n k u:
rantų	r a n t u:
rantų	r a n t u:
raudonąją	r aU d o: n A: j A:
raudonųjų	r aU d o: n u: j u:
raumeningu	r aU m' E n' I n g U
rašomos	r A: S o: m o: s
rašto	r A: S t o:
realizuoti	r' E a l' I z UO t' I
realybe	r' E a l' i: b' E
redukuotais	r' E d U k UO t aI s
referendumą	r' E f' E r' E n d U m A:
reforma	r' E f O r m a
registruotas	r' E g' I s t r UO t a s
reikalauja	r' EI k a 5 aU j a
reikalavimą	r' EI k a 5 A: v' I m A:
reikalavo	r' EI k a 5 A: v o:
reikalingas	r' EI k a l' I n g a s
reikšmingi	r' EI k S' m' I n' g' I
reikšmę	r' EI k S' m' {:
reikšmę	r' EI k S' m' {:
reisinis	r' EI s' I n' I s
reiškia	r' EI S' k' a
reiškinys	r' EI S' k' I n' i: s
reiškė	r' EI S' k' e:
reiškėsi	r' EI S' k' e: s' I
reklamuoti	r' E k 5 a m UO t' I
rekonstrukcijai	r' E k O n s t r U k ts' I j aI
rekonstrukcijos	r' E k O n s t r U k ts' I j o: s
rekordinio	r' E k O r' d' I n' o:
rekordinį	r' E k O r' d' I n' i:
rengiasi	r' E n' g' a s' I
renginiais	r' E n' g' I n' aI s
renginio	r' E n' g' I n' o:
renginių	r' E n' g' I n' u:
rengti	r' E n' k t' I
rengti	r' E n' k t' I
renkasi	r' E n k a s' I
reputaciją	r' E p U t A: ts' I j A:
restoranai	r' E s t O r A: n aI
restruktūrizavimo	r' E s t r U k t u: r' I z A: v' I m o:
retai	r' E t aI
revanšistinių	r' E v a n' S' I s' t' I n' u:
rezervatas	r' E z' E r v A: t a s
rezidencijos	r' E z' I d' E n' ts' I j o: s
rezidentų	r' E z' I d' E n t u:
rezultatas	r' E z U 5 t A: t a s
rezultatus	r' E z U 5 t a t U s
režisierius	r' E Z' I s' Ie r' U s
riama	r' a m a
riaušes	r' aU S' E s
ribojasi	r' I b o: j a s' I
riešutais	r' Ie S U t aI s
rifą	r' I f A:
rinkas	r' I n k a s
rinkoje	r' I n k o: j E
rinkos	r' I n k o: s
rinktinė	r' I n' k t' I n' e:
rinktinėje	r' I n' k t' I n' e: j E
rinktinę	r' I n' k t' I n' {:
rinktis	r' I n' k t' I s
rinką	r' I n k A:
rizikos	r' I z' I k o: s
rišti	r' I S' t' I
rišti	r' I S' t' I
rodo	r o: d o:
rodoma	r o: d o: m a
rogutėmis	r o: g U t' e: m' I s
rojus	r o: j U s
romantiškas	r o: m a n' t' I S k a s
ropliai	r o: p' l' aI
ruda	r U d a
ruda	r U d a
rudenėlio	r U d' E n' e: l' o:
rudenį	r U d' E n' i:
rugienas	r U g' Ie n a s
rugių	r U g' u:
runos	r U n o: s
ruošiasi	r UO S' a s' I
ryte	r' i: t' E
ryte	r' i: t' E
ryti	r' i: t' I
ryti	r' i: t' I
rytinę	r' i: t' I n' {:
rytų	r' i: t u:
ryškiai	r' i: S' k' aI
rėkia	r' e: k' a
rėkė	r' e: k' e:
rėmėjai	r' e: m' e: j aI
rėmėjų	r' e: m' e: j u:
rūbų	r u: b u:
rūpimus	r u: p' I m U s
rūpintis	r u: p' I n' t' I s
rūšių	r u: S' u:
rūšį	r u: S' i:
sakei	s a k' EI
sakinyje	s a k' I n' i: j E
sako	s A: k o:
sakome	s A: k o: m' E
saldainis	s a 5 d aI n' I s
saldiklis	s a l' d' I k l' I s
salotas	s a 5 o: t a s
salotas	s a 5 o: t a s
samdyti	s a m' d' i: t' I
sandorius	s a n d o: r' U s
santechniku	s a n' t' E x' n' I k U
santuokos	s a n t UO k o: s
santuokų	s a n t UO k u:
santykius	s a n' t' i: k' U s
sau	s aU
saugo	s aU g o:
saugoma	s aU g o: m a
saugotis	s aU g o: t' I s
saulei	s aU l' EI
saulė	s aU l' e:
saulės	s aU l' e: s
saulėtekio	s aU l' e: t' E k' o:
savaites	s a v aI t' E s
savaitė	s a v aI t' e:
savas	s A: v a s
savas	s a v a s
savijautai	s a v' I j aU t aI
savireklamos	s a v' I r' E k 5 A: m o: s
savisaugos	s a v' I s aU g o: s
savivaldybė	s a v' I v a l' d' i: b' e:
savivaldybę	s a v' I v a l' d' i: b' {:
savu	s a v U
sceną	s' ts' E n A:
segamas	s' {: g a m a s
sekimo	s' E k' I m o:
sekina	s' {: k' I n a
sekretoriatas	s' E k r' E t o: r' I j A: t a s
senamiestyje	s' E n A: m' Ie s' t' i: j E
senas	s' {: n a s
senas	s' E n a s
senelis	s' E n' {: l' I s
seniai	s' E n' aI
seniai	s' {: n' aI
seniausia	s' E n' aU s' a
seniausio	s' E n' aU s' o:
senieji	s' E n' Ie j I
senolis	s' E n o: l' I s
senovine	s' E n o: v' I n' E
sensacinga	s' E n s a ts' I n g a
senstančiai	s' E n s t a n' tS' aI
senėjimo	s' E n' e: j I m o:
septintieji	s' E p' t' I n' t' Ie j I
septinto	s' E p' t' I n t o:
septintos	s' E p' t' I n t o: s
septintos	s' E p' t' I n t o: s
septyn	s' E p' t' i: n
septyniasdešimti	s' E p' t' i: n' a z' d' E S' I m' t' I
septyniasdešimti	s' E p' t' i: n' a z' d' {: S' I m' t' I
septyniasdešimti	s' E p' t' i: n' a z' d' E S' I m' t' I
septyniolikto	s' E p' t' i: n' o: l' I k t o:
septynioliktą	s' E p' t' i: n' o: l' I k t A:
septynioliktų	s' E p' t' i: n' o: l' I k t u:
serbai	s' E r b aI
serga	s' E r g a
sergant	s' E r g a n t
sergantiems	s' E r g a n' t' Ie m s
sergančių	s' E r g a n' tS' u:
sesuo	s' E s UO
sezono	s' E z O n o:
sezonu	s' E z O n U
sezonui	s' E z O n Ui
siekia	s' Ie k' a
siekiai	s' Ie k' aI
siekiant	s' Ie k' a n t
sieks	s' Ie k s
sielas	s' Ie 5 a s
signalą	s' I g n A: 5 A:
simbolizuoja	s' I m b O l' I z UO j a
sinoptikai	s' I n O p' t' I k aI
sionalai	s' I j O n A: 5 aI
sirgaliai	s' I r g A: l' aI
sistemai	s' I s' t' E m aI
sistemų	s' I s' t' E m u:
situacija	s' I t U A: ts' I j a
situaciją	s' I t U A: ts' I j A:
situacijų	s' I t U A: ts' I j u:
siuntimo	s' U n' t' I m o:
siūloma	s' u: 5 o: m a
siūlymui	s' u: l' i: m Ui
skaityti	s k aI t' i: t' I
skaičiumi	s k aI tS' U m' I
skaičių	s k aI tS' u:
skamba	s k a m b a
skambalėlis	s k a m b a l' e: l' I s
skambalėlių	s k a m b a l' e: l' u:
skambesiu	s k a m' b' E s' U
skambučiai	s k a m b U tS' aI
skambėjimo	s k a m' b' e: j I m o:
skambėjo	s k a m' b' e: j o:
skandalas	s k a n d A: 5 a s
skanų	s k A: n u:
skatina	s k A: t' I n a
skatinti	s k A: t' I n' t' I
skausminga	s k aU s' m' I n g a
skausmą	s k aU s m A:
skelbia	s' k' E l' b' a
skelbia	s' k' E l' b' a
skelbimų	s' k' E l' b' I m u:
skelbti	s' k' E l' p' t' I
skelbti	s' k' E l' p' t' I
skelbti	s' k' E l' p' t' I
skeletas	s' k' E l' E t a s
skeptiškai	s' k' E p' t' I S k aI
skiria	s' k' I r' a
skiriama	s' k' I r' a m a
skiriama	s' k' I r' a m a
skirstomas	s' k' I r s t o: m a s
skirtingoje	s' k' I r' t' I n g o: j E
skirtingų	s' k' I r' t' I n g u:
skleidžia	s' k l' EI dZ' a
skonį	s k o: n' i:
skrendama	s' k r' E n d a m a
skrendama	s' k r' E n d a m a
skrydis	s' k r' i: d' I s
skrydžiai	s' k r' i: dZ' aI
skuba	s k U b a
skuba	s k U b a
skulptūrų	s k U 5 p t u: r u:
skundžiasi	s k U n' dZ' a s' I
skurdžiai	s k U r' dZ' aI
skydai	s' k' i: d aI
skydai	s' k' i: d aI
skyriuje	s' k' i: r' U j E
skyrusią	s' k' i: r U s A:
skyrė	s' k' i: r' e:
slaptumu	s 5 a p t U m U
slėnį	s' l' e: n' i:
slėpimo	s' l' e: p' I m o:
smalsuolius	s m a 5 s UO l' U s
smarkiai	s m a r' k' aI
smegduobė	s' m' {: g d UO b' e:
smegenis	s' m' {: g' E n' I s
smegenyse	s' m' E g' E n' i: s' E
smegenų	s' m' E g' E n u:
smulkmenų	s m U l' k m' E n u:
socialiniame	s O ts' I j A: l' I n' a m' E
socialiniame	s O ts' A: l' I n' a m' E
socialinio	s O ts' I j A: l' I n' o:
socialinio	s O ts' A: l' I n' o:
socialinius	s O ts' I j A: l' I n' U s
socialinius	s O ts' A: l' I n' U s
sociologinio	s O ts' I j O 5 O g' I n' o:
sociologinio	s O ts' O 5 O g' I n' o:
sodininkystės	s o: d' I n' I n' k' i: s' t' e: s
sodybas	s o: d' i: b a s
sodą	s o: d A:
sodą	s O d A:
sostine	s o: s' t' I n' E
sostinėje	s o: s' t' I n' e: j E
sostinės	s o: s' t' I n' e: s
sostinėse	s o: s' t' I n' e: s' E
sostinę	s o: s' t' I n' {:
sovietmečiu	s O v' Ie t' m' E tS' U
spalvas	s p a 5 v a s
spalvose	s p a 5 v o: s' E
spauda	s p aU d a
spauda	s p aU d a
spaudinėti	s p aU d' I n' e: t' I
spausdinti	s p aU z' d' I n' t' I
specialybė	s' p' E ts' I j a l' i: b' e:
specialybė	s' p' E ts' a l' i: b' e:
specialybės	s' p' E ts' I j a l' i: b' e: s
specialybės	s' p' E ts' a l' i: b' e: s
spektras	s' p' E k t r a s
spindulių	s' p' I n d U l' u:
spintoje	s' p' I n t o: j E
sportininkai	s p O r' t' I n' I n k aI
sportininkas	s p O r' t' I n' I n k a s
sportinis	s p O r' t' I n' I s
sportuoti	s p O r t UO t' I
sprendimas	s' p' r' E n' d' I m a s
sprendimus	s' p' r' E n' d' I m U s
sprendžia	s' p' r' E n' dZ' a
sprendžiama	s' p' r' E n' dZ' a m a
sprendžiama	s' p' r' E n' dZ' a m a
sprendžiame	s' p' r' E n' dZ' a m' E
spręsti	s' p' r' {: s' t' I
spręsti	s' p' r' {: s' t' I
spūstis	s p u: s' t' I s
srityje	s' r' I t' i: j E
stabilizuoti	s t a b' I l' I z UO t' I
stabtelėjo	s t a p' t' E l' e: j o:
stagnaciją	s t a g n A: ts' I j A:
staiga	s t aI g a
stalo	s t A: 5 o:
startuoja	s t a r t UO j a
statinių	s t A: t' I n' u:
statinių	s t a t' I n' u:
statinių	s t a t' I n' u:
statinės	s t a t' I n' e: s
statoma	s t A: t o: m a
statomos	s t A: t o: m o: s
stebėjimo	s' t' E b' e: j I m o:
stebėjo	s' t' E b' e: j o:
stepėse	s' t' {: p' e: s' E
stevijos	s' t' E v' I j o: s
stiklinių	s' t' I k l' I n' u:
stilistė	s' t' I l' I s' t' e:
stiprina	s' t' I p' r' I n a
stiprinančiomis	s' t' I p' r' I n a n' tS' o: m' I s
stipriosiomis	s' t' I p' r' o: s' o: m' I s
stipriąsias	s' t' I p r A: s' a s
stiprybę	s' t' I p' r' i: b' {:
stogo	s t o: g o:
stovykla	s t o: v' i: k 5 a
stovykla	s t o: v' i: k 5 a
stovyklautojai	s t o: v' i: k 5 aU t o: j aI
stovėti	s t o: v' e: t' I
straipsniuose	s t r aI p' s' n' UO s' E
straipsnius	s t r aI p' s' n' U s
straipsnių	s t r aI p' s' n' u:
strategija	s t r a t' E g' I j a
strategijos	s t r a t' E g' I j o: s
striukė	s' t' r' U k' e:
studentai	s t U d' E n t aI
studija	s t U d' I j a
studijas	s t U d' I j a s
studijuojanti	s t U d' I j UO j a n' t' I
studijuosianti	s t U d' I j UO s' a n' t' I
studijų	s t U d' I j u:
studio	s t U d' I j O
stulpai	s t U 5 p aI
suartina	s U a r' t' I n a
suartinti	s U a r' t' I n' t' I
suaugusiems	s U aU g U s' Ie m s
subtropinis	s U p t r O p' I n' I s
sucypia	s U ts' i: p' a
sucypia	s U ts' i: p' a
sudarymas	s U d A: r' i: m a s
sudarytas	s U d a r' i: t a s
sudėties	s U d' e: t' Ie s
sudėtingas	s U d' e: t' I n g a s
sudėtingi	s U d' e: t' I n' g' I
suformuota	s U f O r m UO t a
sugadinanti	s U g a d' I n a n' t' I
sugadinantis	s U g a d' I n a n' t' I s
sugavo	s U g A: v o:
sugebėjo	s U g' E b' e: j o:
sugedusio	s U g' {: d U s' o:
sukelia	s U k' E l' a
sukelti	s U k' E l' t' I
sukelti	s U k' E l' t' I
suknelę	s U k n' {: l' {:
sukreč	s U k r' E tS
sukrečia	s U k r' E tS' a
sukčiaujančių	s U k tS' aU j a n' tS' u:
sultis	s U l' t' I s
sumažintus	s U m A: Z' I n t U s
sumokėjo	s U m o: k' e: j o:
sumokėti	s U m o: k' e: t' I
sunešti	s U n' E S' t' I
sunešti	s U n' E S' t' I
sunkiai	s U n' k' aI
sunkmečiu	s U n' k m' E tS' U
sunkmečiui	s U n' k m' E tS' Ui
sunku	s U n k U
sunkumai	s U n k U m aI
sunkumus	s U n k U m U s
suoliuką	s UO l' U k A:
suplanuoti	s U p 5 a n UO t' I
supo	s U p o:
surasti	s U r a s' t' I
surasti	s U r a s' t' I
surengta	s U r' E n k t a
surengta	s U r' E n k t a
surinko	s U r' I n k o:
susidarymo	s U s' I d A: r' i: m o:
susiduria	s U s' I d U r' a
susidūrė	s U s' I d u: r' e:
susidūręs	s U s' I d u: r' {: s
susieisime	s U s' I EI s' I m' E
susijusi	s U s' I j U s' I
susilaikyti	s U s' I 5 aI k' i: t' I
susilpnėjus	s U s' I l' p' n' e: j U s
susipažįsta	s U s' I p a Z' i: s t a
susirasti	s U s' I r a s' t' I
susirasti	s U s' I r a s' t' I
susirinko	s U s' I r' I n k o:
susisiekti	s U s' I s' Ie k t' I
suskaičiuoti	s U s k aI tS' UO t' I
sutartyje	s U t a r' t' i: j E
suteiktas	s U t' EI k t a s
sutelkimas	s U t' E l' k' I m a s
suvaldymo	s U v a l' d' i: m o:
suvyniotas	s U v' i: n' o: t a s
sušildo	s U S' I 5 d o:
sužinoti	s U Z' I n o: t' I
svarbesnė	s v a r' b' E s' n' e:
svarbi	s v a r' b' I
svarbiausią	s v a r' b' aU s' A:
svarbiausių	s v a r' b' aU s' u:
svarbus	s v a r b U s
sveikatai	s' v' EI k A: t aI
sveiki	s' v' EI k' I
sveiki	s' v' EI k' I
svetimo	s' v' {: t' I m o:
svetur	s' v' E t U r
svečiams	s' v' E tS' a m s
svečias	s' v' {: tS' a s
svečius	s' v' E tS' U s
svečių	s' v' E tS' u:
sąkandis	s A: k a n' d' I s
sąlygiški	s A: l' i: g' I S' k' I
sąlygomis	s A: l' i: g o: m' I s
sąlygų	s A: l' i: g u:
sąsajų	s A: s a j u:
sėdimą	s' e: d' I m A:
sėdėjome	s' e: d' e: j o: m' E
sėdėti	s' e: d' e: t' I
sėkmingai	s' e: k m' I n g aI
sėkmės	s' e: k m' e: s
sėkmės	s' e: k m' e: s
tabako	t a b A: k o:
tada	t a d a
tadienis	t A: d' Ie n' I s
talentingų	t a l' E n' t' I n g u:
tamsiąją	t a m' s' A: j A:
tančiai	t a n' tS' aI
tapo	t A: p o:
taps	t a p s
tapti	t a p' t' I
tapusi	t A: p U s' I
tariamą	t A: r' a m A:
tarifai	t a r' I f aI
tarimas	t a r' I m a s
tarmė	t a r' m' e:
tarmės	t a r' m' e: s
tarmės	t a r' m' e: s
tarnautojams	t a r n aU t o: j a m s
tarpininkus	t a r' p' I n' I n k U s
tarpininkus	t a r' p' I n' I n k U s
tarpininkus	t a r' p' I n' I n k U s
tarptautinė	t a r p t aU t' I n' e:
tarptautinėje	t a r p t aU t' I n' e: j E
tarybai	t a r' i: b aI
tas	t a s
taupymą	t aU p' i: m A:
tauta	t aU t a
tauta	t aU t a
tautiečiai	t aU t' Ie tS' aI
tautiečius	t aU t' Ie tS' U s
tautiečius	t aU t' Ie tS' U s
tautą	t aU t A:
teatriukas	t' E a t' r' U k a s
teatro	t' E A: t r o:
teatru	t' E a t r U
teatru	t' E A: t r U
teatrą	t' E A: t r A:
tebuvo	t' E b U v o:
technologija	t' E x n O 5 O g' I j a
technologijas	t' E x n O 5 O g' I j a s
technologijų	t' E x n O 5 O g' I j u:
tegalėjo	t' E g a l' e: j o:
teikia	t' EI k' a
teikiamos	t' EI k' a m o: s
teikiamos	t' EI k' a m o: s
teisingos	t' EI s' I n g o: s
teisininkai	t' EI s' I n' I n k aI
teisinės	t' EI s' I n' e: s
teismas	t' EI s m a s
teismo	t' EI s m o:
teismui	t' EI s m Ui
teisė	t' EI s' e:
teisė	t' EI s' e:
teisės	t' EI s' e: s
teisės	t' EI s' e: s
teks	t' E k s
tekstą	t' E k s t A:
tekti	t' E k t' I
tekėjimą	t' E k' e: j I m A:
telefonas	t' E l' E f O n a s
telefonas	t' E l' E f O n a s
telefonų	t' E l' E f O n u:
telefonų	t' E l' E f O n u:
televizija	t' E l' E v' I z' I j a
televizoriaus	t' E l' E v' I z o: r' aU s
televizorinius	t' E l' E v' I z O r' I n' U s
televizorius	t' E l' E v' I z o: r' U s
telkinius	t' E l' k' I n' U s
tempimo	t' E m' p' I m o:
tempo	t' E m p o:
tendencija	t' E n' d' E n' ts' I j a
tendencijas	t' E n' d' E n' ts' I j a s
tendencijos	t' E n' d' E n' ts' I j o: s
tenka	t' E n k a
tenkina	t' E n' k' I n a
teorijos	t' E O r' I j o: s
teoriniai	t' E O r' I n' aI
terapija	t' E r A: p' I j a
terapijos	t' E r A: p' I j o: s
tereikia	t' E r' EI k' a
teritorija	t' E r' I t O r' I j a
testai	t' E s t aI
testas	t' E s t a s
testosterono	t' E s t O s' t' E r O n o:
tiekėjų	t' Ie k' e: j u:
tiesiog	t' Ie s' o: k
tiesiogiai	t' Ie s' o: g' aI
tiesioginių	t' Ie s' o: g' I n' u:
tiesų	t' Ie s u:
tiesų	t' Ie s u:
tikimybė	t' I k' I m' i: b' e:
tikrais	t' I k r aI s
tikram	t' I k r a m
tikras	t' I k r a s
tikras	t' I k r a s
tikriesiems	t' I k r' Ie s' Ie m s
tikrovės	t' I k r o: v' e: s
tikrovę	t' I k r o: v' {:
tikrumo	t' I k r U m o:
tikslais	t' I k s 5 aI s
tikslą	t' I k s 5 A:
tiktų	t' I k t u:
tikėjimo	t' I k' e: j I m o:
tiltas	t' I 5 t a s
tinklalapį	t' I n k 5 A: 5 a p' i:
tinklas	t' I n k 5 a s
tinkle	t' I n' k l' E
tinkle	t' I n' k l' E
tinklą	t' I n k 5 A:
tiria	t' I r' a
tiriamos	t' I r' a m o: s
tiriamos	t' I r' a m o: s
tis	t' I s
tobulai	t o: b U 5 aI
tobulai	t o: b U 5 aI
tobulinti	t o: b U l' I n' t' I
tobulėti	t o: b U l' e: t' I
toji	t o: j I
tokia	t o: k' a
tokia	t o: k' a
tokio	t o: k' o:
tokią	t o: k' A:
tokių	t o: k' u:
tolerancijos	t O l' E r a n' ts' I j o: s
toliau	t o: l' aU
tolimesnio	t o: l' I m' E s' n' o:
tradicijas	t r a d' I ts' I j a s
tradicijų	t r a d' I ts' I j u:
tradiciniams	t r a d' I ts' I n' a m s
tradicinio	t r a d' I ts' I n' o:
tradicinių	t r a d' I ts' I n' u:
trados	t r A: d O s
tragedijų	t r a g' E d' I j u:
tragiškai	t r A: g' I S k aI
transformatorius	t r a n s f O r m A: t O r' U s
trapus	t r a p U s
traukia	t r aU k' a
traukiniai	t r aU k' I n' aI
treniruotėje	t' r' E n' I r UO t' e: j E
trestas	t' r' E s t a s
trečdalis	t' r' {: dZ d a l' I s
trečiadienio	t' r' E tS' A: d' Ie n' o:
trečiadienį	t' r' E tS' A: d' Ie n' i:
trečioji	t' r' E tS' o: j I
trečiuoju	t' r' E tS' UO j U
trečią	t' r' {: tS' A:
trečiąjį	t' r' {: tS' A: j i:
trikampis	t' r' I k a m' p' I s
trikampis	t' r' I k a m' p' I s
tris	t' r' I s
trisdešimtą	t' r' I z' d' E S' I m t A:
triukšmas	t' r' U k S m a s
triumfas	t' r' I j U m f a s
trišimt	t' r' I S' I m t
triškumo	t' r' I S k U m o:
trokšta	t r o: k S t a
trokšta	t r o: k S t a
troškulį	t r o: S k U l' i:
trukmė	t r U k m' e:
truksiantis	t r U k s' a n' t' I s
trumpoms	t r U m p O m s
truputį	t r U p U t' i:
trylik	t' r' i: l' I k
trylikos	t' r' i: l' I k o: s
tryliktoji	t' r' i: l' I k t o: j I
tryliktų	t' r' i: l' I k t u:
tryliktųjų	t' r' i: l' I k t u: j u:
tunelių	t U n' E l' u:
tuokiantis	t UO k a n' t' I s
tupėjo	t U p' e: j o:
turgų	t U r g u:
turintiems	t U r' I n' t' Ie m s
turinčios	t U r' I n' tS' o: s
turinčių	t U r' I n' tS' u:
turistai	t U r' I s t aI
turistams	t U r' I s t a m s
turistus	t U r' I s t U s
turistų	t U r' I s t u:
turizmo	t U r' I z m o:
turių	t U r' u:
turto	t U r t o:
tuvoje	t U v o: j E
tvarkingai	t v a r' k' I n g aI
tvenkiniai	t' v' E n' k' I n' aI
tvenkiniais	t' v' E n' k' I n' aI s
tvorą	t v o: r A:
tylėjo	t' i: l' e: j o:
tyrimas	t' i: r' I m a s
tyrinėja	t' i: r' I n' e: j a
tyvuliuoja	t' i: v U l' UO j a
tėvus	t' e: v U s
tėvus	t' e: v U s
tėčio	t' e: tS' o:
tęsiamas	t' {: s' a m a s
tęsiasi	t' {: s' a s' I
tūkstantais	t u: k s t a n t aI s
tūkstantiai	t u: k s t a n' t' aI
tūkstantį	t u: k s t a n' t' i:
tūkstantųjų	t u: k s t a n t u: j u:
tūkstančius	t u: k s t a n' tS' U s
tų	t u:
ugdo	U g d o:
ugdyti	U g d' i: t' I
ugnikalnio	U g n' I k a l' n' o:
ultimatumo	U l' t' I m A: t U m o:
unijos	U n' I j o: s
unikalus	U n' I k a 5 U s
universalinė	U n' I v' E r s A: l' I n' e:
universitetas	U n' I v' E r' s' I t' E t a s
universitetą	U n' I v' E r' s' I t' E t A:
uodai	UO d aI
uogas	UO g a s
uoslės	UO s' l' e: s
uostai	UO s t aI
uostą	UO s t A:
upelio	U p' {: l' o:
upę	U p' {:
uždarbį	U Z d a r' b' i:
uždaviniai	U Z d a v' I n' aI
uždavinį	U Z d a v' I n' i:
uždirbantys	U Z' d' I r b a n' t' i: s
uždrausta	U Z d r aU s t a
uždrausta	U Z d r aU s t a
užduoties	U Z d UO t' Ie s
užduočių	U Z d UO tS' u:
užkalk	U S k a 5 k
užkemšamos	U S' k' E m S a m o: s
užklausą	U S k 5 aU s A:
užlipo	U Z' l' I p o:
užmatė	U Z m A: t' e:
užmiršti	U Z' m' I r' S' t' I
užmiršti	U Z' m' I r' S' t' I
užmušė	U Z m U S' e:
užplūdo	U S p 5 u: d o:
užrašų	U Z r a S u:
užsakius	U s A: k' U s
užsakius	U S s A: k' U s
užsakovas	U s a k o: v a s
užsakovas	U S s a k o: v a s
užsegtą	U s' E k t A:
užsegtą	U S' s' E k t A:
užsienyje	U s' Ie n' i: j E
užsienyje	U S' s' Ie n' i: j E
užtariantis	U S t a r' a n' t' I s
užtikrinti	U S' t' I k r' I n' t' I
užuot	U Z UO t
vabaliūkščius	v a b a l' u: k S' tS' U s
vadina	v a d' I n a
vadinamą	v a d' I n a m A:
vadovėlyje	v a d o: v' e: l' i: j E
vadovų	v a d o: v u:
vagies	v a g' Ie s
vaidino	v aI d' I n o:
vaidmenį	v aI d' m' E n' i:
vaiduoklį	v aI d UO k l' i:
vaikais	v aI k aI s
vaikams	v aI k a m s
vaikinu	v aI k' I n U
vaikinu	v aI k' I n U
vaikystės	v aI k' i: s' t' e: s
vaiką	v aI k A:
vaikštinėjantį	v aI k S' t' I n' e: j a n' t' i:
vairuojant	v aI r UO j a n t
vairuotoja	v aI r UO t o: j a
vairuotojas	v aI r UO t o: j a s
vairuotojo	v aI r UO t o: j o:
vaistinių	v aI s' t' I n' u:
vaizduojamosios	v aI z d UO j a m o: s' o: s
vakarais	v a k a r aI s
vakarienę	v a k a r' Ie n' {:
vakarą	v A: k a r A:
vakarų	v a k a r u:
valdantieji	v a 5 d a n' t' Ie j I
valdančiosios	v a 5 d a n' tS' o: s' o: s
valdininkams	v a l' d' I n' I n k a m s
valdo	v a 5 d o:
valdžiai	v a l' dZ' aI
valgių	v a l' g' u:
valgyklėlę	v a l' g' i: k l' e: l' {:
valstijas	v a l' s' t' I j a s
valstijas	v a l' s' t' I j a s
valstybei	v a l' s' t' i: b' EI
valstybinė	v a l' s' t' i: b' I n' e:
valstybinės	v a l' s' t' i: b' I n' e: s
vanduo	v a n d UO
varpai	v a r p aI
varpai	v a r p aI
varpeliai	v a r' p' {: l' aI
varpinę	v a r' p' I n' {:
varpinę	v a r' p' I n' {:
vartoja	v a r t o: j a
vartojo	v a r t o: j o:
vartotojų	v a r t o: t o: j u:
varžovų	v a r Z o: v u:
vasara	v A: s a r a
vasarai	v A: s a r aI
vasarinę	v a s a r' I n' {:
važinėja	v a Z' I n' e: j a
važinėti	v a Z' I n' e: t' I
važiuoja	v a Z' UO j a
važiuojančio	v a Z' UO j a n' tS' o:
vedly	v' E d' l' i:
vedė	v' {: d' e:
vedėja	v' E d' e: j a
vedų	v' E d u:
veiduose	v' EI d UO s' E
veikia	v' EI k' a
veiklos	v' EI k 5 o: s
veiklos	v' EI k 5 o: s
veiksmo	v' EI k s m o:
veiksmuose	v' EI k s m UO s' E
veiksmų	v' EI k s m u:
veikė	v' EI k' e:
veislės	v' EI s' l' e: s
veltis	v' E l' t' I s
verslininkai	v' E r' s' l' I n' I n k aI
verslininkas	v' E r' s' l' I n' I n k a s
verslininkui	v' E r' s' l' I n' I n k Ui
vertimai	v' E r' t' I m aI
vertimų	v' E r' t' I m u:
vertina	v' E r' t' I n a
vertinamos	v' E r' t' I n a m o: s
vertingiausi	v' E r' t' I n' g' aU s' I
vertinti	v' E r' t' I n' t' I
vertybes	v' E r' t' i: b' E s
vertybė	v' E r' t' i: b' e:
vertėjos	v' E r' t' e: j o: s
vestuves	v' E s t U v' E s
vestuves	v' E s t U v' E s
veteranų	v' E t' E r A: n u:
vežęs	v' {: Z' {: s
vidaus	v' I d aU s
video	v' I d' E O
viduramžiais	v' I d U r a m' Z' aI s
vidurdienį	v' I d U r' d' Ie n' i:
vidurnaktį	v' I d U r n a k t' i:
vidutiniškai	v' I d U t' I n' I S k aI
vienašališkų	v' Ie n a S A: l' I S k u:
vieni	v' Ie n' I
vieni	v' Ie n' I
vienijasi	v' Ie n' I j a s' I
vieninteliai	v' Ie n' I n' t' E l' aI
vienoje	v' Ie n o: j E
vienoje	v' Ie n o: j E
vienos	v' Ie n o: s
vienos	v' Ie n o: s
viens	v' Ie n s
vienu	v' Ie n U
vienuolikos	v' Ie n UO l' I k o: s
vienuoliktoji	v' Ie n UO l' I k t o: j I
vienuoliktu	v' Ie n UO l' I k t U
vietas	v' Ie t a s
vietiniais	v' Ie t' I n' aI s
vietinė	v' Ie t' I n' e:
vietoj	v' Ie t O j
vietoje	v' Ie t o: j E
vietomis	v' Ie t o: m' I s
vietovardžių	v' Ie t o: v a r' dZ' u:
vietų	v' Ie t u:
viešai	v' Ie S aI
viešai	v' Ie S aI
viešbučio	v' Ie Z b U tS' o:
viešnios	v' Ie S' n' o: s
viešnios	v' Ie S' n' o: s
viešojo	v' Ie S o: j o:
viliojami	v' I l' o: j a m' I
vilkėjęs	v' I l' k' e: j {: s
vilos	v' I 5 o: s
violetinę	v' O l' E t' I n' {:
virtinė	v' I r' t' I n' e:
virškinimą	v' I r' S' k' I n' I m A:
viršūnėje	v' I r S u: n' e: j E
visa	v' I s a
visa	v' I s a
visas	v' I s a s
visas	v' I s a s
visi	v' I s' I
viskas	v' I s k a s
viskas	v' I s k a s
viso	v' I s o:
visos	v' I s o: s
visos	v' I s o: s
visuma	v' I s U m a
visuma	v' I s U m a
visuomenei	v' I s UO m' E n' EI
visuose	v' I s UO s' E
visuotinės	v' I s UO t' I n' e: s
viziją	v' I z' I j A:
vizų	v' I z u:
vokalinės	v O k A: l' I n' e: s
vokiečius	v o: k' Ie tS' U s
vokiečių	v o: k' Ie tS' u:
vykdo	v' i: g d o:
vykdoma	v' i: g d o: m a
vyko	v' i: k o:
vynuogių	v' i: n UO g' u:
vyrams	v' i: r a m s
vyrauja	v' i: r aU j a
vyriausias	v' i: r' aU s' a s
vyriausybės	v' i: r' aU s' i: b' e: s
vyro	v' i: r o:
vystosi	v' i: s t o: s' I
vystyti	v' i: s' t' i: t' I
vyte	v' i: t' E
vėlesniam	v' e: l' E s' n' a m
vėlesniam	v' e: l' E s' n' a m
vėliavoje	v' e: l' a v o: j E
vėluojančių	v' e: 5 UO j a n' tS' u:
ypatingas	i: p a t' I n g a s
ypatingomis	i: p a t' I n g o: m' I s
ypatumus	i: p a t U m U s
zoną	z O n A:
ąžuolo	A: Z UO 5 o:
Čaikovskio	tS aI k O v' s' k' o:
Čedasai	tS' E d a s aI
Černiauskas	tS' E r' n' aU s k a s
čempionatas	tS' E m' p' I j O n A: t a s
čempionate	tS' E m' p' I j O n a t' E
čempionatą	tS' E m' p' I j O n A: t A:
čerška	tS' E r S k a
čigonas	tS' I g o: n a s
čiobrelis	tS' o: b' r' {: l' I s
čiuožti	tS' UO S' t' I
čiuožti	tS' UO S' t' I
čiuožykla	tS' UO Z' i: k 5 a
čiuožykla	tS' UO Z' i: k 5 a
Ėrkas	e: r k a s
ėmė	e: m' e:
įdarbinimą	i: d a r' b' I n' I m A:
įdomus	i: d o: m U s
įdėta	i: d' e: t a
įdėta	i: d' e: t a
įgarsa	i: g a r s a
įgarsintos	i: g a r' s' I n t o: s
įgijo	i: g' I j o:
įgūdžius	i: g u: dZ' U s
įkroviklį	i: k r o: v' I k l' i:
įmanoma	i: m A: n o: m a
įmonei	i: m o: n' EI
įmones	i: m o: n' E s
įmontuota	i: m O n t UO t a
įmonėje	i: m o: n' e: j E
įprastas	i: p r a s t a s
įprastinėje	i: p r a s' t' I n' e: j E
įpročiai	i: p r o: tS' aI
įregistruoti	i: r' E g' I s t r UO t' I
įregistruotiems	i: r' E g' I s t r UO t' Ie m s
įsibėgėjus	i: s' I b' e: g' e: j U s
įsikūrusiame	i: s' I k u: r U s' a m' E
įsipareigoja	i: s' I p a r' EI g o: j a
įsipareigojo	i: s' I p a r' EI g o: j o:
įsirėžė	i: s' I r' e: Z' e:
įsitikinę	i: s' I t' I k' I n' {:
įskaičiuotas	i: s k aI tS' UO t a s
įspūdį	i: s p u: d' i:
įstaigas	i: s t aI g a s
įstaigos	i: s t aI g o: s
įstaigose	i: s t aI g o: s' E
įstaigų	i: s t aI g u:
įstatymų	i: s t A: t' i: m u:
įsteigtas	i: s' t' EI k t a s
įstoti	i: s t o: t' I
įtaigiai	i: t aI g' aI
įtakos	i: t a k o: s
įtaką	i: t a k A:
įtariamuoju	i: t a r a m UO j U
įteisino	i: t' EI s' I n o:
įtūžę	i: t u: Z' {:
įvairialypę	i: v aI r' a l' i: p' {:
įvairias	i: v aI r' a s
įvairiausiais	i: v aI r' aU s' aI s
įvairiausius	i: v aI r' aU s' U s
įvairiomis	i: v aI r' o: m' I s
įvairovę	i: v aI r o: v' {:
įvardyti	i: v a r' d' i: t' I
įvedė	i: v' E d' e:
įveikti	i: v' EI k t' I
įveikti	i: v' EI k t' I
įvertinti	i: v' E r' t' I n' t' I
įvykis	i: v' i: k' I s
įvyks	i: v' i: k s
Šarausko	S a r aU s k o:
Šarkauskaitė	S a r k aU s k aI t' e:
Šarūnas	S a r u: n a s
Šatkienė	S a t' k' Ie n' e:
Šeduva	S' E d U v a
Šeporaitis	S' E p o: r aI t' I s
Šeškinė	S' E S' k' I n' e:
Šiauliai	S' aU l' aI
Šilalė	S' I 5 A: l' e:
Šimulynas	S' I m U l' i: n a s
Šlektavičius	S' l' E k t A: v' I tS' U s
Šumkauskas	S U m k aU s k a s
Šunskai	S U n s k aI
Švedija	S' v' E d' I j a
Šveicarija	S' v' EI ts A: r' I j a
Šventežeris	S' v' E n' t' E Z' E r' I s
Švenčionys	S' v' E n' tS' o: n' i: s
šaldyto	S a l' d' i: t o:
šaltibarščius	S a l' t' I b a r' S' tS' U s
šaltuoju	S a 5 t UO j U
šalį	S A: l' i:
šarka	S a r k a
šedevrų	S' E d' E v r u:
šeima	S' EI m a
šeima	S' EI m a
šeimai	S' EI m aI
šeimininkų	S' EI m' I n' I n k u:
šeimyninės	S' EI m' i: n' I n' e: s
šeimą	S' EI m A:
šernai	S' E r n aI
šeš	S' E S
šešiasdešimti	S' E S' a z' d' E S' I m' t' I
šešiasdešimtų	S' E S' a z' d' E S' I m t u:
šešiasdešimtų	S' E S' a z' d' {: S' I m t u:
šešiolikos	S' E S' o: l' I k o: s
šešioliktoji	S' E S' o: l' I k t o: j I
šešis	S' E S' I s
šeštadienis	S' E S t A: d' Ie n' I s
šeštas	S' E S t a s
šeštas	S' {: S t a s
šeštą	S' {: S t A:
šešėlio	S' E S' e: l' o:
šia	S' a
šiaurietiška	S' aU r' Ie t' I S k a
šilta	S' I 5 t a
šilta	S' I 5 t a
šimtaprocentines	S' I m t a p r O ts' E n' t' I n' E s
šimtaprocentines	S' I m t a p r O ts' E n' t' I n' E s
šimtą	S' I m t A:
širdies	S' I r' d' Ie s
šiuo	S' UO
šiuolaikiniam	S' UO 5 aI k' I n' a m
šiuolaikinių	S' UO 5 aI k' I n' u:
šiuolaikinė	S' UO 5 aI k' I n' e:
šiuolaikinė	S' UO 5 aI k' I n' e:
šiuos	S' UO s
šių	S' u:
šlovingasai	S 5 o: v' I n g a s aI
šluota	S 5 UO t a
šnipų	S' n' I p u:
šoka	S o: k a
šokis	S o: k' I s
šokoladinis	S O k O 5 A: d' I n' I s
šokoladinių	S O k O 5 A: d' I n' u:
šokoladą	S O k O 5 A: d A:
šokėjo	S o: k' e: j o:
špinatų	S' p' I n A: t u:
šturmavo	S t U r m A: v o:
šunys	S U n' i: s
šunį	S U n' i:
šuo	S UO
šuolis	S UO l' I s
šurmuliu	S U r m U l' U
šveicarams	S' v' EI ts A: r a m s
šviesa	S' v' Ie s a
šviesa	S' v' Ie s a
švieslentėje	S' v' Ie s' l' E n' t' e: j E
šviežio	S' v' Ie Z' o:
šviežių	S' v' Ie Z' u:
šypsenas	S' i: p' s' E n a s
ūkio	u: k' o:
Žardininkai	Z a r' d' I n' I n k aI
Žarėnai	Z a r' e: n aI
Žebrauskas	Z' E b r aU s k a s
Žeimaitijos	Z' EI m aI t' I j o: s
Žeimiai	Z' EI m' aI
Želva	Z' E 5 v a
Žemaitiją	Z' E m aI t' I j A:
Žiauberis	Z' aU b' E r' I s
Žiurinskienė	Z' U r' I n' s' k' Ie n' e:
Živilė	Z' I v' I l' e:
Žuikienė	Z Ui k' Ie n' e:
Žulkienė	Z U l' k' Ie n' e:
žada	Z A: d a
žaidimas	Z aI d' I m a s
žaidimus	Z aI d' I m U s
žaidėjų	Z aI d' e: j u:
žaidėme	Z aI d' e: m' E
žaidžiamas	Z aI dZ' a m a s
žalios	Z a l' o: s
žalios	Z A: l' o: s
žalsvą	Z a 5 s v A:
žaltys	Z a l' t' i: s
žavėjausi	Z a v' e: j aU s' I
žemas	Z' {: m a s
žemas	Z' E m a s
žemė	Z' {: m' e:
ženklam	Z' E n k 5 a m
ženklams	Z' E n k 5 a m s
ženklas	Z' E n k 5 a s
ženkliai	Z' E n' k l' aI
ženklų	Z' E n k 5 u:
ženklų	Z' E n k 5 u:
žiedai	Z' Ie d aI
žiedo	Z' Ie d o:
žiemos	Z' Ie m o: s
žinau	Z' I n aU
žiniasklaidai	Z' I n' A: s k 5 aI d aI
žiniasklaidos	Z' I n' A: s k 5 aI d o: s
žinios	Z' I n' o: s
žinios	Z' I n' o: s
žinių	Z' I n' u:
žino	Z' I n o:
žinoma	Z' I n o: m a
žinomumą	Z' I n o: m U m A:
žiogai	Z' o: g aI
žiūrovų	Z' u: r o: v u:
žiūrėjimas	Z' u: r' e: j I m a s
žiūrėk	Z' u: r' e: k
žmones	Z m o: n' E s
žmonija	Z m o: n' I j a
žmonija	Z m o: n' I j a
žmonijos	Z m o: n' I j o: s
žmonėmis	Z m o: n' e: m' I s
žodžio	Z o: dZ' o:
žudiką	Z U d' I k A:
žurnalistams	Z U r n a l' I s t a m s
žurnalistų	Z U r n a l' I s t u:
žurnalą	Z U r n A: 5 A:
žuvis	Z U v' I s
žvaigždė	Z v aI g Z' d' e:
žvaigždės	Z v aI g Z' d' e: s
žvejai	Z' v' E j aI
žvilgsnis	Z' v' I l' k s' n' I s
žydinčių	Z' i: d' I n' tS' u:
žygio	Z' i: g' o:
žygis	Z' i: g' I s
žymaus	Z' i: m aU s
žymus	Z' i: m U s
<hes>	G I m
<hes>	I m
<hes>	a
<hes>	A:
A	A:
A	a
Abraitis	a b r aI t' I s
Adelė	a d' E l' e:
Adolfas	A: d O 5 f a s
Adomaitienė	a d o: m aI t' Ie n' e:
Adomavičius	a d o: m A: v' I tS' U s
Afganistano	a f g a n' I s t A: n o:
Agnė	A: g n' e:
Agrorodeo	a g r O r O d' E O
Airinga	aI r' I n g a
Aistė	aI s' t' e:
Akmenė	a k m' {: n' e:
Akropolio	a k r O p O l' o:
Aleksonis	a l' E k s o: n' I s
Alna	a 5 n a
Alna	a 5 n a
Alytus	a l' i: t U s
Alytus	a l' i: t U s
Amerikoje	a m' E r' I k o: j E
Amerikos	a m' E r' I k o: s
Andrejaitis	a n' d' r' E j aI t' I s
Andrius	a n' d' r' U s
Angela	a n' g' E 5 a
Antrajam	a n t r A: j a m
Anykščiai	a n' i: k S' tS' aI
Anykščiai	a n' i: k S' tS' aI
Apanavičius	a p a n A: v' I tS' U s
Aplinkos	a p' l' I n k o: s
Apuolėje	a p UO l' e: j E
Arimeks	a r' I m' E k s
Arnolda	a r n O 5 d a
Artis	a r' t' I s
Artūras	a r t u: r a s
Artūras	a r t u: r a s
Arvydas	a r' v' i: d a s
Arvydas	a r' v' i: d a s
Astos	A: s t o: s
Astra	a s t r a
Astra	A: s t r a
Atlanto	a t 5 a n t o:
Audrius	aU d' r' U s
Audrius	aU d' r' U s
Augustina	aU g U s' t' I n a
Augustina	aU g U s' t' I n a
Aurika	aU r' I k a
Aurika	aU r' I k a
Aurimas	aU r' I m a s
Austė	aU s' t' e:
Azerbaidžanas	a z' E r b aI dZ A: n a s
Azerbaidžaną	a z' E r b aI dZ A: n A:
Bagaslaviškis	b a g a s 5 a v' I S' k' I s
Bagaslaviškis	b a g a s 5 A: v' I S' k' I s
Bagdonas	b a g d o: n a s
Balio	b A: l' o:
Baltarusijoje	b a 5 t a r U s' I j o: j E
Baltijos	b a l' t' I j o: s
Baniulis	b a n' U l' I s
Bank	b a n k
Barkauskas	b a r k aU s k a s
Barselona	b a r' s' E 5 O n a
Barselona	b a r' s' E 5 O n a
Barstyčiai	b a r' s' t' i: tS' aI
Bazienė	b a z' Ie n' e:
Belfasto	b' E 5 f a s t o:
Belfasto	b' E 5 f A: s t o:
Belgrado	b' E 5 g r A: d o:
Belgrado	b' E 5 g r a d o:
Belkevičienė	b' E l' k' {: v' I tS' Ie n' e:
Bendida	b' E n' d' I d a
Bengalijoje	b' E n g A: l' I j o: j E
Benjaminas	b' E n' j a m' I n a s
Betonika	b' E t O n' I k a
Birutė	b' I r U t' e:
Blažytė	b 5 a Z' i: t' e:
Bomelio	b O m' E l' o:
Boreika	b o: r' EI k a
Boreika	b o: r' EI k a
Britanijoje	b' r' I t A: n' I j o: j E
Britaniją	b' r' I t A: n' I j A:
Bronius	b r O n' U s
Bugaitė	b U g aI t' e:
Bugaitė	b U g aI t' e:
Butkevičius	b U t' k' {: v' I tS' U s
Butkevičius	b U t' k' {: v' I tS' U s
Butrimonys	b U t' r' I m o: n' i: s
Bylienė	b' i: l' Ie n' e:
Dalia	d a l' a
Danguolė	d a n g UO l' e:
Danske	d a n' s' k' E
Daugai	d aU g aI
Debrecenas	d' E b' r' E ts' E n a s
Didždvaris	d' I dZ d v a r' I s
Didžiojoje	d' I dZ' o: j o: j E
Didžiąją	d' I dZ' A: j A:
Digrys	d' I g r' i: s
Domicelė	d O m' I ts' E l' e:
Dominykas	d o: m' I n' i: k a s
Donatas	d O n A: t a s
Druskininkai	d r U s' k' I n' I n k aI
Dzeta	dz' E t a
Dzeusas	dz' EU s a s
Dzūkijoje	dz u: k' I j o: j E
Dzūkijos	dz u: k' I j o: s
Džakarta	dZ a k a r t a
Džaulio	dZ aU l' o:
Džaulis	dZ aU l' I s
Džeimso	dZ' EI m s o:
Džomolungma	dZ O m O 5 U n g m a
Džomolungmos	dZ O m O 5 U n g m o: s
Džordžija	dZ O r' dZ' I j a
Džordžijos	dZ O r' dZ' I j o: s
Džordžtaunas	dZ O r tS t aU n a s
Džordžtaune	dZ O r tS t aU n' E
Džordžtauną	dZ O r tS t aU n A:
Edgaras	E d g a r a s
Edita	E d' I t a
Edita	E d' I t a
Edvinas	E d' v' I n a s
Egidijus	E g' I d' I j U s
Egipto	E g' I p t o:
Eimantas	EI m a n t a s
Einoras	EI n o: r a s
Ekscelencija	E k s' ts' E l' E n' ts' I j a
Elektrokomplektas	E l' E k t r O k O m' p' l' E k t a s
Elena	E l' E n a
Elparma	E 5 p a r m a
Elžbieta	E l' Z' b' Ie t a
Elžbieta	E l' Z' b' Ie t a
Endriejavas	E n' d' r' Ie j A: v a s
Erikas	E r' I k a s
Euroga	EU r O g a
Europoje	EU r O p o: j E
Europos	EU r O p o: s
Evaldas	E v a 5 d a s
Everestu	E v' E r' E s t U
Everestu	E v' E r' E s t U
Filipas	f' I l' I p a s
Finansų	f' I n a n s u:
Gajanos	g a j A: n o: s
Garso	g a r s o:
Gediminas	g' E d' I m' I n a s
Gedimino	g' E d' I m' I n o:
Gedion	g' E d' I j O n
Genovaitė	g' E n O v aI t' e:
Giedre	g' Ie d' r' E
Giedre	g' Ie d' r' E
Giedrė	g' Ie d' r' e:
Gintarė	g' I n t a r' e:
Gintarė	g' I n t a r' e:
Gintarė	g' I n t A: r' e:
Goro	g O r O
Griškabūdis	g r' I S k a b u: d' I s
Gruziją	g r U z' I j A:
Gudeliai	g U d' {: l' aI
Guntienė	g U n' t' Ie n' e:
H_Permono	G A: p' E r m o: n o:
Himalajų	G' I m a 5 A: j u:
Himalo	G' I m a 5 O
Holdings	G O l' d' I n k s
Iduna	I d U n a
Ieva	Ie v a
Ieva	Ie v a
Ignalina	I g n a l' I n a
Ignalina	I g n a l' I n a
Indijos	I n' d' I j o: s
Inga	I n g a
Irutė	I r U t' e:
Islandija	I s 5 a n' d' I j a
Ispanijoje	I s p A: n' I j o: j E
Italijoje	I t A: l' I j o: j E
J	j O t
Japonijos	j a p O n' I j o: s
Jieznas	j Ie z n a s
Joana	j O a n a
Joana	j O A: n a
Jolanta	j o: 5 a n t a
Jonas	j o: n a s
Jovita	j O v' I t a
Jovita	j O v' I t a
Jucienė	j U ts' Ie n' e:
Julijona	j U l' I j o: n a
Julijona	j U l' I j o: n a
Julijonas	j U l' I j o: n a s
Julius	j U l' U s
Juozapota	j UO z a p o: t a
Juozapota	j UO z a p o: t a
Juozas	j UO z a s
Jurbarkas	j U r b a r k a s
Jurga	j U r g a
Jurgita	j U r' g' I t a
Justinas	j U s' t' I n a s
Justiniškės	j U s' t' I n' I S' k' e: s
Juškevičius	j U S' k' {: v' I tS' U s
Jūratė	j u: r A: t' e:
Jūsų	j u: s u:
K_G	k A: g' e:
Kaišiadorys	k aI S' a d o: r' i: s
Kanų	k A: n u:
Kapčiamiestis	k A: p' tS' a m' Ie s' t' I s
Kapčiamiestis	k a p' tS' A: m' Ie s' t' I s
Karolina	k a r O l' I n a
Karolina	k a r O l' I n a
Karolis	k A: r O l' I s
Karčiauskienė	k a r' tS' aU s' k' Ie n' e:
Kaunas	k aU n a s
Kaune	k aU n' E
Kaune	k aU n' E
Kauno	k aU n o:
Kautra	k aU t r a
Kautra	k aU t r a
Kaveckas	k a v' {: ts k a s
Kazimierinės	k a z' I m' Ie r' I n' e: s
Kazlų	k a z 5 u:
Kazys	k a z' i: s
Kazė	k A: z' e:
Kazė	k a z' e:
Kernavė	k' E r n a v' e:
Kernavė	k' E r n A: v' e:
Kinijoje	k' I n' I j o: j E
Kinijos	k' I n' I j o: s
Kirkorovas	k' I r k O r O v a s
Kirtimai	k' I r' t' I m aI
Kleinauskas	k l' EI n aU s k a s
Koliziejus	k O l' I z' Ie j U s
Kolorado	k O 5 O r A: d o:
Konradas	k O n r a d a s
Konstantino	k O n s t a n' t' I n o:
Konstituciją	k O n' s' t' I t U ts' I j A:
Kopenhagos	k O p' E n G A: g o: s
Krepšta	k r' E p S t a
Kretoje	k r' E t o: j E
Kristaus	k r' I s t aU s
Krokialaukis	k r o: k' a 5 aU k' I s
Krėvė	k r' e: v' e:
Kušlienė	k U S' l' Ie n' e:
Kęstas	k' {: s t a s
Kūčios	k u: tS' o: s
Kūčios	k u: tS' o: s
Labrenciškė	5 A: b' r' E n' ts' I S' k' e:
Laima	5 aI m a
Laimonas	5 aI m o: n a s
Laižuva	5 aI Z U v a
Laura	5 aU r a
Lazdijai	5 a z' d' I j aI
Lenkijoje	l' E n' k' I j o: j E
Leopoldas	l' E O p O 5 d a s
Lietuva	l' Ie t U v a
Lietuvių	l' Ie t U v' u:
Lietuvoje	l' Ie t U v o: j E
Lietuvos	l' Ie t U v o: s
Lietuvą	l' Ie t U v A:
Lina	l' I n a
Lina	l' I n a
Linas	l' I n a s
Linas	l' I n a s
Lingvobalt	l' I n g v O b a 5 t
Linkuva	l' I n k U v a
Linkuva	l' I n k U v a
Lipniuvienės	l' I p' n' U v' Ie n' e: s
Lisabona	l' I s a b O n a
Lisabona	l' I s a b O n a
Litnaglis	l' I t n a g l' I s
Liucija	l' U ts' I j a
Liudas	l' U d a s
Lotynų	5 o: t' i: n u:
Lukas	5 U k a s
Lukšių	5 U k S' u:
Luvro	5 U v r o:
Lytagra	l' i: t a g r a
Lytagra	l' i: t A: g r a
Lėipkalnis	l' e: I p k a l' n' I s
Macijauskaitė	m a ts' I j aU s k aI t' e:
Magdalena	m a g d a l' E n a
Magdalena	m a g d a l' {: n a
Mahanlangūro	m a G a n 5 a n g u: r o:
Marijampolė	m a r' I j a m p o: l' e:
Marius	m A: r' U s
Markel	m a r' k' E 5
Martynas	m a r' t' i: n a s
Matuzienė	m A: t U z' Ie n' e:
Medija	m' E d' I j a
Mikalojaus	m' I k a 5 o: j aU s
Mindaugas	m' I n d aU g a s
Mindaugo	m' I n d aU g o:
Mingo	m' I n g o:
Mira	m' I r a
Mira	m' I r a
Modestas	m O d' E s t a s
Monika	m O n' I k a
Motiejus	m O t' Ie j U s
Motiejūnaitė	m o: t' Ie j u: n aI t' e:
Motinos	m o: t' I n o: s
Muzikos	m U z' I k o: s
Mykolas	m' i: k O 5 a s
Nacionalinis	n a ts' I j O n A: l' I n' I s
Nacionalinis	n a ts' O n A: l' I n' I s
Nafta	n a f t a
Nafta	n A: f t a
Naujamiestis	n aU j A: m' Ie s' t' I s
Naujieji	n aU j Ie j I
Nepalo	n' E p A: 5 o:
Nerija	n' {: r' I j a
Nerija	n' E r' I j a
Neringa	n' E r' I n g a
Noliškio	n o: l' I S' k' o:
Norfos	n O r f o: s
Odeta	o: d' E t a
Orisoje	O r' I s o: j E
Otas	o: t a s
Ovidijus	O v' I d' I j U s
Pakalnienė	p a k a l' n' Ie n' e:
Pakalnienė	p a k a l' n' Ie n' e:
Pakaunėje	p a k aU n' e: j E
Panemunė	p a n' E m U n' e:
Panemunėlis	p a n' E m U n' e: l' I s
Paryžiaus	p a r' i: Z' aU s
Paulius	p aU l' U s
Paulius	p aU l' U s
Paškevičiūtė	p a S' k' E v' I tS' u: t' e:
Pernarava	p' E r n a r a v a
Perskaudienės	p' E r s k aU d' Ie n' e: s
Petru	p' E t r U
Pijus	p' I j U s
Pikeliai	p' I k' E l' aI
Pilviškiai	p' I l' v' I S' k' aI
Plateliai	p 5 A: t' E l' aI
Platonas	p 5 a t O n a s
Pociūnėliai	p o: ts' u: n' e: l' aI
Pranas	p r A: n a s
Prancūziją	p r a n ts u: z' I j A:
Preskoto	p' r' E s k O t O
Prezidentūra	p' r' E z' I d' E n t u: r a
Prezidentūra	p' r' E z' I d' E n t u: r a
Puckiene	p U ts' k' Ie n' E
Putokšnis	p U t o: k S' n' I s
Ramunaitė	r a m U n aI t' e:
Rapolas	r A: p O 5 a s
Rasa	r a s a
Rasmera	r a s' m' E r a
Rasmera	r a s' m' E r a
Raudonė	r aU d o: n' e:
Regina	r' E g' I n a
Regina	r' E g' I n a
Remigijus	r' E m' I g' I j U s
Renata	r' E n a t a
Rima	r' I m a
Rima	r' I m a
Rimantas	r' I m a n t a s
Rimas	r' I m a s
Rimkai	r' I m k aI
Rimkus	r' I m k U s
Rita	r' I t a
Rita	r' I t a
Rivona	r' I v O n a
Rokas	r o: k a s
Rokiškis	r o: k' I S' k' I s
Rolandas	r o: 5 a n d a s
Romas	r O m a s
Romas	r o: m a s
Romos	r O m o: s
Romos	r o: m o: s
Rudamina	r U d a m' I n a
Rudamina	r U d a m' I n a
Rudenėlio	r U d' E n' e: l' o:
Rusijai	r U s' I j aI
Rusijos	r U s' I j o: s
Rūda	r u: d a
Rūtė	r u: t' e:
S_B_ai	E S b' e: aI
Samanta	s a m a n t a
Samargathos	s a m a r g A: t G O s
Sandra	s a n d r a
Sasnava	s a s n a v a
Sasnava	s a s n A: v a
Saulius	s aU l' U s
Saulės	s aU l' e: s
Savickas	s a v' I ts k a s
Seimo	s' EI m o:
Sidnėjus	s' I d' n' e: j U s
Sigita	s' I g' I t a
Sigita	s' I g' I t a
Sigitas	s' I g' I t a s
Skirmantas	s' k' I r m a n t a s
Skudutis	s k U d U t' I s
Sokratas	s O k r A: t a s
Sokrato	s O k r A: t o:
Studija	s t U d' I j a
Subačius	s U b a tS' U s
Sąjungos	s A: j U n g o: s
Tadas	t A: d a s
Tarvydytė	t a r' v' i: d' i: t' e:
Tauragė	t aU r a g' e:
Tauragės	t aU r a g' e: s
Telšiai	t' E l' S' aI
Teresė	t' E r' E s' e:
Tokijuje	t O k' I j U j E
Tomas	t O m a s
Trakuose	t r A: k UO s' E
Trakuose	t r a k UO s' E
Trevena	t' r' E v' E n a
Tyrilienė	t' i: r' I l' Ie n' e:
Tėvo	t' e: v o:
Ukmergės	U k m' E r' g' e: s
Ukrainos	U k r a I n o: s
Utena	U t' E n a
Utena	U t' E n a
Užkaukazės	U S k aU k a z' e: s
Vaclovas	v A: ts 5 O v a s
Vaida	v aI d a
Vaiva	v aI v a
Vaišnorienė	v aI S n o: r' Ie n' e:
Valančiūnas	v a 5 a n' tS' u: n a s
Valdas	v a 5 d a s
Valdas	v a 5 d a s
Valstijų	v a l' s' t' I j u:
Varniai	v a r' n' aI
Varniai	v a r' n' aI
Vaškai	v a S k aI
Velykos	v' E l' i: k o: s
Ventus	v' E n t U s
Vertimų	v' E r' t' I m u:
Vida	v' I d a
Vida	v' I d a
Vidas	v' I d a s
Viduržemio	v' I d U r' Z' E m' o:
Viešpatie	v' Ie S p a t' Ie
Viešpatie	v' Ie S p a t' Ie
Vija	v' I j a
Vija	v' I j a
Vilkpėdė	v' I l' k p' e: d' e:
Vilkyškiai	v' I l' k' i: S' k' aI
Vilma	v' I 5 m a
Vilniaus	v' I l' n' aU s
Vilnius	v' I l' n' U s
Vilunta	v' I 5 U n t a
Vincas	v' I n ts a s
Virginija	v' I r' g' I n' I j a
Visų	v' I s u:
Vitafarma	v' I t a f a r m a
Vitaras	v' I t a r a s
Vitė	v' I t' e:
Voldemaras	v O l' d' E m A: r a s
Vorld	v O r 5 d
Vytautas	v' i: t aU t a s
Vėžauskienė	v' e: Z aU s' k' Ie n' e:
Zapyškis	z a p' i: S' k' I s
Zenonas	z' E n O n a s
Zia	z' I j a
Zimblytė	z' I m' b' l' i: t' e:
Zubovų	z U b O v u:
a	A:
a	a
abėcėlės	a b' e: ts' e: l' e: s
aikštelės	aI k S' t' {: l' e: s
akcentas	a k ts' E n t a s
akcentas	A: k ts' E n t a s
akivaizdoj	a k' I v aI z d O j
akių	a k' u:
akmenį	A: k m' E n' i:
akmuo	a k m UO
aktorius	A: k t o: r' U s
aktorių	A: k t o: r' u:
aktyvumas	a k t' i: v U m a s
akys	A: k' i: s
akį	A: k' i:
albumas	a 5 b U m a s
alkoholio	a 5 k O G O l' o:
alternatyva	a l' t' E r n a t' i: v a
alternatyva	a l' t' E r n a t' i: v a
amerikietė	a m' E r' I k' Ie t' e:
amerikiečiai	a m' E r' I k' Ie tS' aI
anglai	a n g 5 aI
anglakalbėms	a n g 5 a k a l' b' e: m s
angliavandenių	a n' g l' a v a n' d' {: n' u:
angliški	a n' g l' I S' k' I
anglų	a n g 5 u:
anksčiau	a n' k S' tS' aU
ankštinių	a n' k S' t' I n' u:
ansamblio	a n s a m' b' l' o:
ant	a n t
antra	a n t r a
antra	a n t r a
antradienis	a n t r A: d' Ie n' I s
antradienį	a n t r A: d' Ie n' i:
antri	a n' t' r' I
antroji	a n t r o: j I
antrą	a n t r A:
antrų	a n t r u:
antrųjų	a n t r u: j u:
apdailai	A: b d aI 5 aI
apie	a p' Ie
apimtiems	a p' I m' t' Ie m s
apkartina	a p k a r' t' I n a
apsiginčiau	a p' s' I g' I n' tS' aU
apsižiūrėsime	a p' s' I Z' u: r' e: s' I m' E
apsčiai	a p' S' tS' aI
apvali	a p v a l' I
apysakų	a p' i: s a k u:
apytiksliai	a p' i: t' I k s' l' aI
apžiūrėk	a b' Z' u: r' e: k
apžvalgos	A: b Z v a 5 g o: s
apžvalgos	a b Z v a 5 g o: s
ar	a r
arba	a r b a
arbatą	a r b A: t A:
architektai	a r' x' I t' E k t aI
architektūros	a r' x' I t' E k t u: r o: s
arkliams	a r' k l' a m s
artimiausiu	a r' t' I m' aU s' U
artimiesiems	a r' t' I m' Ie s' Ie m s
artėjant	a r' t' e: j a n t
asketizmu	a s' k' E t' I z m U
asketizmu	a s' k' E t' I z m U
asmeninis	a s' m' E n' I n' I s
asmeninis	a s' m' {: n' I n' I s
asmenybė	a s' m' E n' i: b' e:
asmenybę	a s' m' E n' i: b' {:
asmenų	a s' m' E n u:
astronomai	a s t r O n O m aI
atakuojama	a t a k UO j a m a
ateina	a t' EI n a
ateityje	a t' EI t' i: j E
ateitį	A: t' EI t' i:
atgavo	a d g A: v o:
atgavę	a d g A: v' {:
atidaroma	a t' I d A: r o: m a
atidirbimo	a t' I d' I r' b' I m o:
atitinkamai	a t' I t' I n k a m aI
atjojantys	a t' j o: j a n' t' i: s
atkūrimo	a t k u: r' I m o:
atleidžiama	a t' l' EI dZ' a m a
atleidžiama	a t' l' EI dZ' a m a
atleidžiami	a t' l' EI dZ' a m' I
atlieka	a t' l' Ie k a
atlieka	A: t' l' Ie k a
atlieka	a t' l' Ie k a
atlikta	a t' l' I k t a
atlikta	a t' l' I k t a
atlikti	a t' l' I k t' I
atlikti	a t' l' I k t' I
atlikėjas	a t' l' I k' e: j a s
atlikėjos	a t' l' I k' e: j o: s
atlyginimai	a t' l' i: g' I n' I m aI
atmosfera	a t m O s' f' E r a
atmosfera	a t m O s' f' E r a
atneša	a t' n' E S a
atomų	a t O m u:
atostogų	a t o: s t o: g u:
atrado	a t r A: d o:
atrasti	a t r a s' t' I
atrasti	a t r a s' t' I
atrinktos	a t' r' I n k t o: s
atrinktos	a t' r' I n k t o: s
atrodė	a t r o: d' e:
atsakomybės	a t s a k o: m' i: b' e: s
atsakyti	a t s a k' i: t' I
atsargesni	a t s a r' g' E s' n' I
atsidūrė	a t' s' I d u: r' e:
atsigauti	a t' s' I g aU t' I
atsigauti	a t' s' I g aU t' I
atsiliepimą	a t' s' I l' Ie p' I m A:
atsirado	a t' s' I r A: d o:
atsiranda	a t' s' I r a n d a
atsiriboti	a t' s' I r' I b o: t' I
atsisakė	a t' s' I s A: k' e:
atskleista	a t' s' k l' EI s t a
atskleista	a t' s' k l' EI s t a
atspalviai	A: t s p a l' v' aI
atspindintis	a t' s' p' I n' d' I n' t' I s
atspindys	a t' s' p' I n' d' i: s
atvaizdu	A: t v aI z d U
atvejų	A: t' v' E j u:
atveria	a t' v' E r' a
atvežęs	a t' v' {: Z' {: s
atvyksta	a t' v' i: k s t a
atvėsus	a t' v' e: s U s
audringas	aU d' r' I n g a s
auginant	aU g' I n a n t
auklėjimą	aU k l' e: j I m A:
aukšta	aU k S t a
aukšta	aU k S t a
aukštoji	aU k S t o: j I
aukščiausias	aU k S' tS' aU s' a s
autobuso	aU t O b U s o:
automobiliai	aU t O m O b' I l' aI
automobilis	aU t O m O b' I l' I s
automobiliu	aU t O m O b' I l' U
automobilių	aU t O m O b' I l' u:
automobilių	aU t O m O b' I l' u:
autoritetų	aU t O r' I t' E t u:
avys	A: v' i: s
aš	a S
aštunta	a S t U n t a
aštunta	a S t U n t a
aštunti	a S t U n' t' I
aštuntieji	a S t U n' t' Ie j I
aštunto	a S t U n t o:
aštuntą	a S t U n t A:
aštuntų	a S t U n t u:
aštuntųjų	a S t U n t u: j u:
aštuoni	a S t UO n' I
aštuoni	a S t UO n' I
aštuonias	a S t UO n' a s
aštuoniasdešimt	a S t UO n' a z' d' {: S' I m t
aštuoniasdešimt	a S t UO n' a z' d' {: S' I m t
aštuoniasdešimti	a S t UO n' a z' d' E S' I m' t' I
aštuoniolika	a S t UO n' o: l' I k a
aštuoniolikos	a S t UO n' o: l' I k o: s
aštuoniolikta	a S t UO n' o: l' I k t a
aštuoniolikto	a S t UO n' o: l' I k t o:
aštuonioliktoji	a S t UO n' o: l' I k t o: j I
aštuonioliktą	a S t UO n' o: l' I k t A:
aštuonios	a S t UO n' o: s
aštuonių	a S t UO n' u:
baidarę	b aI d A: r' {:
baigiamos	b aI g' a m o: s
baigiamos	b aI g' a m o: s
baigimo	b aI g' I m o:
baigė	b aI g' e:
baigėsi	b aI g' e: s' I
balandžio	b a 5 a n' dZ' o:
baliaus	b A: l' aU s
balionai	b a l' O n aI
balistines	b a l' I s' t' I n' E s
baltieji	b a l' t' Ie j I
bandantys	b a n d a n' t' i: s
bandžiau	b a n' dZ' aU
banginių	b a n' g' I n' u:
bankas	b a n k a s
bankroto	b a n k r O t o:
bankrutavusių	b a n k r U t A: v U s' u:
barzda	b a r z d a
barzda	b a r z d a
baudžia	b aU dZ' a
bazę	b A: z' {:
be	b' E
bebrai	b' {: b r aI
bebrai	b' E b r aI
bedarbiai	b' E d a r' b' aI
bei	b' EI
benamiai	b' E n A: m' aI
bendraudami	b' E n d r aU d a m' I
bendraujame	b' E n d r aU j a m' E
bendravimas	b' E n d r A: v' I m a s
bendrovė	b' E n d r o: v' e:
bendruomenę	b' E n d r UO m' E n' {:
bendrąją	b' E n d r A: j A:
berneliui	b' E r' n' {: l' Ui
berniukas	b' E r' n' U k a s
bet	b' E t
beveik	b' E v' EI k
biokuro	b' I j O k U r o:
birželio	b' I r' Z' {: l' o:
biržietė	b' I r' Z' Ie t' e:
biržoje	b' I r Z o: j E
biudžeto	b' U dZ' E t o:
biuras	b' U r a s
biški	b' I S' k' I
biškį	b' I S' k' i:
blizgių	b' l' I z' g' u:
blizgių	b' l' I z' g' u:
blynus	b' l' i: n U s
blynus	b' l' i: n U s
bokšto	b o: k S t o:
bosnius	b O s' n' U s
botagu	b o: t a g U
brahmanizmą	b r a G m a n' I z m A:
brandi	b r a n' d' I
brangioji	b r a n' g' o: j I
brangsta	b r a n k s t a
britų	b' r' I t u:
broilerių	b r OI l' E r' u:
brolau	b r o: 5 aU
bronzos	b r O n z o: s
bruožas	b r UO Z a s
budistų	b U d' I s t u:
budizmo	b U d' I z m o:
buriuotojams	b U r' UO t o: j a m s
burlaivis	b U r 5 aI v' I s
burlenčių	b U r' l' E n' tS' u:
bus	b U s
buvo	b U v o:
bučiniu	b U tS' I n' U
byloje	b' i: 5 o: j E
bėga	b' e: g a
bėga	b' e: g a
bėga	b' e: g a
būdami	b u: d a m' I
būdas	b u: d a s
būdas	b u: d a s
būdingos	b u: d' I n g o: s
būdu	b u: d U
būstas	b u: s t a s
būstą	b u: s t A:
būti	b u: t' I
būti	b u: t' I
būtybes	b u: t' i: b' E s
būtų	b u: t u:
būtų	b u: t u:
centai	ts' E n t aI
centas	ts' E n t a s
centre	ts' E n' t' r' E
centre	ts' E n' t' r' E
centrinės	ts' E n' t' r' I n' e: s
centro	ts' E n t r o:
centru	ts' E n t r U
centų	ts' E n t u:
chemijos	x' E m' I j o: s
cheminiai	x' E m' I n' aI
cheminio	x' E m' I n' o:
cheminis	x' E m' I n' I s
cheminėmis	x' E m' I n' e: m' I s
chikas	x' I k a s
choro	x O r o:
chorą	x O r A:
cigaretes	ts' I g a r' E t' E s
citrinmedis	ts' I t' r' I n' m' E d' I s
civiliai	ts' I v' I l' aI
cukraus	ts U k r aU s
cukraus	ts U k r aU s
dabar	d a b a r
dadzibo	d a dz' I b O
dailiai	d aI l' aI
dailės	d aI l' e: s
dailės	d aI l' e: s
daina	d aI n a
daina	d aI n a
dainas	d aI n a s
dainininkas	d aI n' I n' I n k a s
dainininką	d aI n' I n' I n k A:
dainuoti	d aI n UO t' I
daktare	d A: k t a r' E
dalgiai	d a l' g' aI
dalgės	d a l' g' e: s
dalies	d a l' Ie s
dalinkimės	d a l' I n' k' I m' e: s
dalis	d a l' I s
dalys	d A: l' i: s
dalys	d a l' i: s
dalyvavo	d a l' i: v A: v o:
dangoraižio	d a n g o: r aI Z' o:
danguje	d a n g U j E
daosizmo	d a O s' I z m o:
dar	d A:
dar	d a r
dar	d a r
darbams	d a r b a m s
darbas	d a r b a s
darbo	d a r b o:
darbuotojų	d a r b UO t o: j u:
darbus	d a r b U s
darbus	d a r b U s
darbą	d a r b A:
darbų	d a r b u:
darbų	d a r b u:
daro	d A: r o:
daryti	d a r' i: t' I
daug	d aU g
daugelis	d aU g' E l' I s
daugeliu	d aU g' E l' U
daugiau	d aU g' aU
daugiausia	d aU g' aU s' a
dauguma	d aU g U m a
dauguma	d aU g U m a
daugumoje	d aU g U m o: j E
daugybės	d aU g' i: b' e: s
davė	d A: v' e:
dažnai	d a Z n aI
dažniau	d a Z' n' aU
dažniausiai	d a Z' n' aU s' aI
dažų	d a Z u:
debatus	d' E b a t U s
debatus	d' E b A: t U s
deformavosi	d' E f O r m A: v o: s' I
derliaus	d' E r' l' aU s
devinta	d' E v' I n t a
devinta	d' E v' I n t a
devinti	d' E v' I n' t' I
devinto	d' E v' I n t o:
devintoji	d' E v' I n t o: j I
devintų	d' E v' I n t u:
devintų	d' E v' I n t u:
devintųjų	d' E v' I n t u: j u:
devyni	d' E v' i: n' I
devyniasdešimt	d' E v' i: n' a z' d' E S' I m t
devyniasdešimt	d' E v' i: n' a z' d' {: S' I m t
devyniolika	d' E v' i: n' o: l' I k a
devyniolikos	d' E v' i: n' o: l' I k o: s
devyniolikta	d' E v' i: n' o: l' I k t a
devynioliktoji	d' E v' i: n' o: l' I k t o: j I
devynios	d' E v' i: n' o: s
devynių	d' E v' i: n' u:
dešimt	d' {: S' I m t
dešimta	d' E S' I m t a
dešimta	d' E S' I m t a
dešimtas	d' E S' I m t a s
dešimtas	d' E S' I m t a s
dešimto	d' E S' I m t o:
dešimtą	d' E S' I m t A:
didelio	d' I d' E l' o:
didelius	d' I d' E l' U s
didelės	d' I d' E l' e: s
didelę	d' I d' E l' {:
didenybe	d' I d' E n' i: b' E
didesne	d' I d' E s' n' E
didesnius	d' I d' E s' n' U s
didesnę	d' I d' E s' n' {:
didieji	d' I d' Ie j I
didina	d' I d' I n a
didvyriai	d' I d' v' i: r' aI
didėja	d' I d' e: j a
didįjį	d' I d' i: j i:
didžiajame	d' I dZ' A: j a m' E
didžiausias	d' I dZ' aU s' a s
didžiavosi	d' I dZ' A: v o: s' I
didžioji	d' I dZ' o: j I
didžiulio	d' I dZ' U l' o:
didžiulis	d' I dZ' U l' I s
didžiulę	d' I dZ' U l' {:
didžiulį	d' I dZ' U l' i:
didžiuosiuose	d' I dZ' UO s' UO s' E
diena	d' Ie n a
diena	d' Ie n a
dienomis	d' Ie n o: m' I s
dienoraštį	d' Ie n o: r a S' t' i:
dienos	d' Ie n o: s
dienos	d' Ie n o: s
dieną	d' Ie n A:
dienų	d' Ie n u:
dinastijos	d' I n A: s' t' I j o: s
dirbančių	d' I r b a n' tS' u:
dirbo	d' I r b o:
dirbti	d' I r' p' t' I
direktoriau	d' I r' E k t O r' aU
diskusijas	d' I s k U s' I j a s
diskusijos	d' I s k U s' I j o: s
dizainerė	d' I z aI n' E r' e:
drastiškai	d r A: s' t' I S k aI
draudimu	d r aU d' I m U
draudžiami	d r aU dZ' a m' I
draugais	d r aU g aI s
draugams	d r aU g a m s
draugas	d r aU g a s
drauge	d r aU g' E
drauge	d r aU g' E
draugija	d r aU g' I j a
draugiškame	d r aU g' I S k a m' E
draugiškumu	d r aU g' I S k U m U
drąsių	d r A: s' u:
du	d U
dujų	d U j u:
duok	d UO k
duomenimis	d UO m' E n' I m' I s
duomenų	d UO m' E n u:
durims	d U r' I m s
dvaro	d v A: r o:
dvi	d' v' I
dvidešimt	d' v' I d' E S' I m t
dvidešimta	d' v' I d' E S' I m t a
dvidešimtą	d' v' I d' E S' I m t A:
dviejų	d' v' Ie j u:
dviem	d' v' Ie m
dviem	d' v' Ie m
dviratininkai	d' v' I r a t' I n' I n k aI
dviračiais	d' v' I r a tS' aI s
dviračiais	d' v' I r A: tS' aI s
dvišimt	d' v' I S' I m t
dvylika	d' v' i: l' I k a
dvylikos	d' v' i: l' I k o: s
dvylikto	d' v' i: l' I k t o:
dvyliktokų	d' v' i: l' I k t o: k u:
dvyliktų	d' v' i: l' I k t u:
dvyliktųjų	d' v' i: l' I k t u: j u:
dydžio	d' i: dZ' o:
dzenbudistines	dz' E n b U d' I s' t' I n' E s
dzenbudizmas	dz' E n b U d' I z m a s
dzimbina	dz' I m' b' I n a
dzingsi	dz' I n' k s' I
dziudo	dz' U d O
dzūkai	dz u: k aI
dzūkiškai	dz u: k' I S k aI
dzūkiškais	dz u: k' I S k aI s
dzūkišku	dz u: k' I S k U
dzūkiškumu	dz u: k' I S k U m U
dėl	d' e: 5
dėmesio	d' e: m' E s' o:
dėstytojau	d' e: s' t' i: t o: j aU
dėžę	d' e: Z' {:
džabos	dZ a b o: s
džaglyja	dZ A: g l' i: j a
džainizmas	dZ aI n' I z m a s
džaivas	dZ aI v a s
džakadomis	dZ a k A: d o: m' I s
džalgą	dZ a 5 g A:
džandža	dZ a n dZ a
džandžarą	dZ a n dZ A: r A:
džarksėjo	dZ a r' k s' e: j o:
džarkšt	dZ a r k S t
džarkšt	dZ a r k S t
džarškant	dZ a r S k a n t
džarškėjo	dZ a r' S' k' e: j o:
džataka	dZ A: t a k a
džatakos	dZ A: t a k o: s
džatra	dZ a t r a
džauliais	dZ aU l' aI s
džaulių	dZ aU l' u:
džerimanderingas	dZ' E r' I m a n' d' E r' I n g a s
džiaugiuosi	dZ' aU g' UO s' I
džiaugtis	dZ' aU k t' I s
džiaugėsi	dZ' aU g' e: s' I
džinsuose	dZ' I n s UO s' E
džokeris	dZ O k' E r' I s
džonka	dZ O n k a
džonką	dZ O n k A:
džuzgūnas	dZ U z g u: n a s
džuzgūno	dZ U z g u: n o:
džvanga	dZ v a n g a
džvangtelėjo	dZ v a n' k t' E l' e: j o:
džvangės	dZ v a n' g' e: s
džvangėsi	dZ v a n' g' e: s' I
džvengės	dZ' v' E n' g' e: s
džvikę	dZ' v' I k' {:
efektyvinti	E f' E k t' i: v' I n' t' I
egzamino	E g z A: m' I n o:
egzaminą	E g z A: m' I n A:
egzaminų	E g z A: m' I n u:
egzemplioriais	E g z' E m' p' l' o: r' aI s
eiliuotai	EI l' UO t aI
eiliuotais	EI l' UO t aI s
eina	EI n a
ekipažas	E k' I p A: Z a s
ekonominės	E k O n O m' I n' e: s
ekscelencija	E k s' ts' E l' E n' ts' I j a
eksperimentų	E k s' p' E r' I m' E n t u:
ekspozicijos	E k s p O z' I ts' I j o: s
ekspozicijų	E k s p O z' I ts' I j u:
ekstremalios	E k s' t' r' E m a l' o: s
ekstremalios	E k s' t' r' E m A: l' o: s
elastanu	E 5 a s t a n U
elastanu	E 5 a s t A: n U
elektros	E l' E k t r o: s
elgesiui	E l' g' E s' Ui
emigraciją	E m' I g r A: ts' I j A:
emocijas	E m O ts' I j a s
emocijų	E m O ts' I j u:
energetikos	E n' E r' g' E t' I k o: s
energijos	E n' E r' g' I j o: s
entomologus	E n t O m O 5 O g U s
entomologus	E n t O m O 5 O g U s
esantys	{: s a n' t' i: s
estrados	E s t r A: d o: s
euro	EU r o:
ežeras	{: Z' E r a s
ežerų	E Z' E r u:
fabrikas	f A: b' r' I k a s
fabrikų	f a b' r' I k u:
fanai	f A: n aI
fantazija	f a n t A: z' I j a
festivalis	f' E s' t' I v A: l' I s
festivalį	f' E s' t' I v A: l' i:
filmai	f' I 5 m aI
filmas	f' I 5 m a s
filmo	f' I 5 m o:
filmukas	f' I 5 m U k a s
filosofas	f' I 5 O s O f a s
filosofijos	f' I 5 O s O f' I j o: s
filosofiją	f' I 5 O s O f' I j A:
filosofų	f' I 5 O s O f u:
finansavimo	f' I n a n s A: v' I m o:
finansinė	f' I n a n' s' I n' e:
fizika	f' I z' I k a
fizinis	f' I z' I n' I s
foninė	f O n' I n' e:
forma	f O r m a
formas	f O r m a s
formos	f O r m o: s
formuojant	f O r m UO j a n t
formą	f O r m A:
forumo	f O r U m o:
fotoaparatą	f O t O a p a r A: t A:
fotografams	f O t O g r A: f a m s
funkcijas	f U n' k ts' I j a s
futbolas	f U d b O 5 a s
gabenus	g a b' {: n U s
gaisras	g aI s r a s
gaisro	g aI s r o:
gali	g a l' I
gali	g A: l' I
galima	g A: l' I m a
galimai	g A: l' I m aI
galimai	g a l' I m aI
galimas	g A: l' I m a s
galimas	g a l' I m a s
galimybių	g a l' I m' i: b' u:
galimybė	g a l' I m' i: b' e:
galimybę	g a l' I m' i: b' {:
galite	g A: l' I t' E
galią	g A: l' A:
galu	g a 5 U
galvoti	g a 5 v o: t' I
galą	g A: 5 A:
galėdama	g a l' e: d a m a
galėdavo	g a l' e: d a v o:
galės	g a l' e: s
gamyba	g a m' i: b a
gamyboje	g a m' i: b o: j E
gamykla	g a m' i: k 5 a
gamykla	g a m' i: k 5 a
gandai	g a n d aI
garbei	g a r' b' EI
garsas	g a r s a s
garsiai	g a r' s' aI
garsių	g a r' s' u:
garso	g a r s o:
garsus	g a r s U s
gatvelėse	g a t' v' {: l' e: s' E
gatviniais	g A: t' v' I n' aI s
gatviniais	g a t' v' I n' aI s
gatvėje	g A: t' v' e: j E
gatvėmis	g A: t' v' e: m' I s
gatvę	g A: t' v' {:
gausybė	g aU s' i: b' e:
gauti	g aU t' I
gauti	g aU t' I
gegužės	g' E g U Z' e: s
gegužės	g' {: g U Z' e: s
gelbėtojai	g' E l' b' e: t o: j aI
geležies	g' E l' E Z' Ie s
gerai	g' E r aI
geras	g' {: r a s
geras	g' E r a s
gerasai	g' E r a s aI
gerbiamasis	g' E r' b' a m a s' I s
geri	g' E r' I
geriausiai	g' E r' aU s' aI
geriausiais	g' E r' aU s' aI s
geriausias	g' E r' aU s' a s
geriems	g' E r' Ie m s
gero	g' {: r o:
gimnazijoje	g' I m n A: z' I j o: j E
gimnaziją	g' I m n A: z' I j A:
gimtadienio	g' I m t A: d' Ie n' o:
gimtinę	g' I m' t' I n' {:
gimė	g' I m' e:
ginklo	g' I n k 5 o:
girdėti	g' I r' d' e: t' I
girdžiu	g' I r' dZ' U
glumina	g 5 U m' I n a
graikų	g r aI k u:
gramatikos	g r a m A: t' I k o: s
gramatinės	g r a m A: t' I n' e: s
grandines	g r a n' d' I n' E s
grandines	g r a n' d' I n' E s
greitesnėmis	g r' EI t' E s' n' e: m' I s
greitąją	g r' EI t A: j A:
griausmą	g r' aU s m A:
griežtai	g r' Ie S t aI
griežtai	g r' Ie S t aI
grindjuosčių	g r' I n' d' j UO S' tS' u:
grindys	g r' I n' d' i: s
grindžiama	g r' I n' dZ' a m a
grindžiama	g r' I n' dZ' a m a
grindžiamas	g r' I n' dZ' a m a s
gripo	g r' I p o:
grožio	g r o: Z' o:
gruodžio	g r UO dZ' o:
grupės	g r U p' e: s
gruzinų	g r U z' I n u:
grybiena	g r' i: b' Ie n a
grybus	g r' i: b U s
grėsmingas	g r' e: s' m' I n g a s
grėsmę	g r' e: s' m' {:
grįžo	g r' i: Z o:
grįžta	g r' i: S t a
gydytojau	g' i: d' i: t o: j aU
gynybos	g' i: n' i: b o: s
gyvas	g' i: v a s
gyvas	g' i: v a s
gyvena	g' i: v' {: n a
gyvename	g' i: v' {: n a m' E
gyvenime	g' i: v' {: n' I m' E
gyvenimo	g' i: v' {: n' I m o:
gyventojų	g' i: v' E n t o: j u:
gyvulių	g' i: v U l' u:
gyvybei	g' i: v' i: b' EI
gyvūnai	g' i: v u: n aI
gyvūnų	g' i: v u: n u:
gėdingu	g' e: d' I n g U
gėlių	g' e: l' u:
gėrėme	g' e: r' e: m' E
harmoningai	G a r m O n' I n g aI
herojė	G' E r O j e:
hospitalizuojamas	G O s' p' I t a l' I z UO j a m a s
ideali	I d' E a l' I
ideali	I d' E A: l' I
idealios	I d' E A: l' o: s
idealios	I d' E a l' o: s
idėjomis	I d' e: j o: m' I s
ietį	Ie t' i:
ieško	j Ie S k o:
ieškoti	j Ie S k o: t' I
ikiteisminiai	I k' I t' EI s' m' I n' aI
ilgai	I 5 g aI
ilgakočiais	I 5 g a k o: tS' aI s
ilgalaikę	I 5 g a 5 aI k' {:
ilgiausia	I l' g' aU s' a
ilgų	I 5 g u:
ilgų	I 5 g u:
ima	I m a
imigraciją	I m' I g r A: ts' I j A:
ims	I m s
imtynės	I m' t' i: n' e: s
indų	I n d u:
infarktas	I n f a r k t a s
informacija	I n f O r m A: ts' I j a
informacijos	I n f O r m A: ts' I j o: s
informavimo	I n f O r m A: v' I m o:
informuojantį	I n f O r m UO j a n' t' i:
iniciatyva	I n' I ts' I j a t' i: v a
iniciatyvų	I n' I ts' I j a t' i: v u:
inkarą	I n k a r A:
inspektoriumi	I n' s' p' E k t O r' U m' I
intarpais	I n t a r p aI s
intelektas	I n' t' E l' E k t a s
interjero	I n' t' E r' j E r o:
internetas	I n' t' E r' n' E t a s
internete	I n' t' E r' n' E t' E
internete	I n' t' E r' n' E t' E
internetinės	I n' t' E r' n' E t' I n' e: s
investavę	I n' v' E s t A: v' {:
investuotojų	I n' v' E s t UO t o: j u:
ir	I r
irkluoti	I r k 5 UO t' I
ispanai	I s p A: n aI
istorijos	I s t O r' I j o: s
istorinę	I s t O r' I n' {:
italai	I t A: 5 aI
itin	I t' I n
iš	I S
išauga	I S aU g a
išbertas	I Z' b' E r t a s
išbūti	I Z b u: t' I
išdėstyta	I Z' d' e: s' t' i: t a
išeities	I S' EI t' Ie s
išgirdau	I Z' g' I r d aU
išgirsti	I Z' g' I r' s' t' I
išgirsti	I Z' g' I r' s' t' I
iškasenos	I S k a s' E n o: s
iškvietė	I S' k v' Ie t' e:
išlaiko	I S 5 aI k o:
išlaikoma	I S 5 aI k o: m a
išlaikytos	I S 5 aI k' i: t o: s
išleidžiama	I S' l' EI dZ' a m a
išlieka	I S' l' Ie k a
išlikti	I S' l' I k t' I
išlipusi	I S' l' I p U s' I
išmėtė	I S' m' e: t' e:
išraiškingas	I S r aI S' k' I n g a s
išreiškiamas	I S' r' EI S' k' a m a s
išsakė	I s A: k' e:
išsakė	I S s A: k' e:
išsaugojo	I s aU g o: j o:
išsaugojo	I S s aU g o: j o:
išsekę	I s' {: k' {:
išsekę	I S' s' {: k' {:
išsidėstęs	I S' s' I d' e: s' t' {: s
išsidėstęs	I s' I d' e: s' t' {: s
išsikėlę	I S' s' I k' e: l' {:
išsikėlę	I s' I k' e: l' {:
išsilaisvinusi	I S' s' I 5 aI s' v' I n U s' I
išsilaisvinusi	I s' I 5 aI s' v' I n U s' I
išsirinkti	I s' I r' I n' k t' I
išsirinkti	I s' I r' I n' k t' I
išsirinkti	I S' s' I r' I n' k t' I
išsirinkti	I S' s' I r' I n' k t' I
išsiskiria	I S' s' I s' k' I r' a
išsiskiria	I s' I s' k' I r' a
išsiuntė	I s' U n' t' e:
išsiuntė	I S' s' U n' t' e:
išsivystymo	I s' I v' i: s' t' i: m o:
išsivystymo	I S' s' I v' i: s' t' i: m o:
išsivysčiusių	I s' I v' i: S' tS' U s' u:
išsivysčiusių	I S' s' I v' i: S' tS' U s' u:
ištikimybė	I S' t' I k' I m' i: b' e:
išvažiuoti	I S v a Z' UO t' I
išvyko	I S' v' i: k o:
jau	j aU
jaukus	j aU k U s
jaukus	j aU k U s
jauniesiems	j aU n' Ie s' Ie m s
jaunimo	j aU n' I m o:
jaunuoli	j aU n UO l' I
jaunuolis	j aU n UO l' I s
jausis	j aU s' I s
jausmus	j aU s m U s
jaustis	j aU s' t' I s
jaučiasi	j aU tS' a s' I
jei	j EI
jeigu	j EI g U
ji	j I
jie	j Ie
jis	j I s
jo	j o:
jogurto	j O g U r t o:
jogurto	j O g U r t o:
jojant	j o: j a n t
jokias	j o: k' a s
jokių	j o: k' u:
judriausia	j U d' r' aU s' a
juodojo	j UO d o: j o:
juridinę	j U r' I d' I n' {:
ją	j A:
jėgas	j e: g a s
jėgos	j e: g o: s
jėgos	j e: g o: s
jūra	j u: r a
jūroje	j u: r o: j E
jūros	j u: r o: s
jūrų	j u: r u:
jūs	j u: s
jūsų	j u: s u:
kablelis	k a b' l' {: l' I s
kablys	k a b' l' i: s
kad	k a d
kai	k aI
kaimais	k aI m aI s
kaimas	k aI m a s
kaimyninėse	k aI m' i: n' I n' e: s' E
kaimynė	k aI m' i: n' e:
kaimynų	k aI m' i: n u:
kaimų	k aI m u:
kaimų	k aI m u:
kainą	k aI n A:
kaip	k aI p
kalakutiena	k a 5 a k U t' Ie n a
kalavijai	k a 5 a v' I j aI
kalavijas	k a 5 a v' I j a s
kalba	k a 5 b a
kalba	k a 5 b a
kalbai	k a 5 b aI
kalbos	k a 5 b o: s
kalbos	k a 5 b o: s
kalbėti	k a l' b' e: t' I
kalbų	k a 5 b u:
kalbų	k a 5 b u:
kalnagūbriui	k a 5 n A: g u: b' r' Ui
kalnas	k a 5 n a s
kalnyno	k a l' n' i: n o:
kalnų	k a 5 n u:
kalvės	k a l' v' e: s
kambariams	k a m b a r' a m s
kambariuose	k a m b a r' UO s' E
kambariuose	k a m b a r' UO s' E
kambaryje	k a m b a r' i: j E
kamera	k A: m' E r a
kanalų	k a n A: 5 u:
kankino	k a n' k' I n o:
kanoną	k a n O n A:
karaliau	k a r A: l' aU
karaliumi	k a r A: l' U m' I
kardai	k a r d aI
kardai	k a r d aI
kardeliais	k a r' d' {: l' aI s
kardą	k a r d A:
kardą	k a r d A:
kareiviams	k a r' EI v' a m s
kareivis	k a r' EI v' I s
kariai	k a r' aI
karjerą	k a r' j E r A:
kartojame	k a r t o: j a m' E
kartu	k a r t U
kartą	k a r t A:
kartą	k a r t A:
karui	k A: r Ui
karą	k A: r A:
karštai	k a r S t aI
karštai	k a r S t aI
karūnavimo	k a r u: n A: v' I m o:
kas	k a s
kasdien	k a z' d' Ie n
kasdienybė	k a z' d' Ie n' i: b' e:
kaspino	k A: s' p' I n o:
katedra	k A: t' E d r a
katė	k a t' e:
kausis	k aU s' I s
kausis	k aU s' I s
kažkas	k a S k a s
kažkur	k a S k U r
kažką	k a S k A:
kdario	g d A: r' o:
keistų	k' EI s t u:
keistų	k' EI s t u:
keleivių	k' E l' EI v' u:
keletas	k' {: l' E t a s
kelia	k' {: l' a
keliais	k' E l' aI s
keliais	k' {: l' aI s
kelias	k' {: l' a s
kelias	k' E l' a s
keliasi	k' {: l' a s' I
keliautojai	k' E l' aU t o: j aI
keliavimas	k' E l' A: v' I m a s
kelininkai	k' {: l' I n' I n k aI
kelio	k' {: l' o:
kelionei	k' E l' o: n' EI
kelionių	k' E l' o: n' u:
kelionėmis	k' E l' o: n' e: m' I s
kelionėse	k' E l' o: n' e: s' E
keliu	k' E l' U
kelius	k' E l' U s
kelių	k' E l' u:
kelių	k' {: l' u:
kepu	k' E p U
keturi	k' E t U r' I
keturiasdešimt	k' {: t U r' a z' d' E S' I m t
keturiasdešimt	k' {: t U r' a z' d' {: S' I m t
keturiasdešimt	k' {: t U r' a z' d' {: S' I m t
keturiasdešimtų	k' E t U r' a z' d' E S' I m t u:
keturiolika	k' E t U r' o: l' I k a
keturiolikos	k' E t U r' o: l' I k o: s
keturiolikta	k' E t U r' o: l' I k t a
keturioliktą	k' E t U r' o: l' I k t A:
keturios	k' {: t U r' o: s
keturių	k' E t U r' u:
ketverius	k' {: t' v' E r' U s
ketvirta	k' E t' v' I r t a
ketvirta	k' E t' v' I r t a
ketvirtadienis	k' E t' v' I r t A: d' Ie n' I s
ketvirtas	k' E t' v' I r t a s
ketvirtas	k' E t' v' I r t a s
ketvirti	k' E t' v' I r' t' I
ketvirto	k' E t' v' I r t o:
ketvirtoji	k' E t' v' I r t o: j I
ketvirtą	k' E t' v' I r t A:
ketvirtų	k' E t' v' I r t u:
ketvirtųjų	k' E t' v' I r t u: j u:
kiaulių	k' aU l' u:
kiek	k' Ie k
kiekis	k' Ie k' I s
kiekviena	k' Ie k v' Ie n a
kiekviena	k' Ie k v' Ie n a
kiekvienas	k' Ie k v' Ie n a s
kiekvieną	k' Ie k v' Ie n A:
kieme	k' Ie m' E
kieme	k' Ie m' E
kiemą	k' Ie m A:
kilometrinę	k' I 5 O m' E t' r' I n' {:
kimono	k' I m O n O
kino	k' I n o:
kinų	k' I n u:
kita	k' I t a
kita	k' I t a
kitais	k' I t aI s
kitokiam	k' I t o: k' a m
kitokių	k' I t o: k' u:
kitos	k' I t o: s
kitos	k' I t o: s
kitą	k' I t A:
kitų	k' I t u:
kišenėse	k' I S' {: n' e: s' E
klaidinančią	k 5 aI d' I n a n' tS' A:
klaidą	k 5 aI d A:
klaidžiai	k 5 aI dZ' aI
klastojimu	k 5 a s t o: j I m U
klasėje	k 5 A: s' e: j E
klausosi	k 5 aU s o: s' I
klientai	k l' I j E n t aI
klijuojami	k l' I j UO j a m' I
klipe	k l' I p' E
kloti	k 5 o: t' I
kloti	k 5 o: t' I
knyga	k n' i: g a
knyga	k n' i: g a
knygos	k n' i: g o: s
knygynuose	k n' i: g' i: n UO s' E
knygą	k n' i: g A:
knygų	k n' i: g u:
kodas	k O d a s
kojas	k o: j a s
kokie	k o: k' Ie
koks	k o: k s
kokybė	k o: k' i: b' e:
kokį	k o: k' i:
kokį	k o: k' i:
kol	k O 5
kolega	k O l' E g a
kolega	k O l' E g a
komanda	k O m a n d a
komandų	k O m a n d u:
komisiją	k O m' I s' I j A:
kompanija	k O m p A: n' I j a
kompiuterių	k O m' p' U t' E r' u:
komplimentų	k O m' p' l' I m' E n t u:
koncernas	k O n' ts' E r n a s
koncertai	k O n' ts' E r t aI
koncerto	k O n' ts' E r t o:
konflikto	k O n' f' l' I k t o:
konkurencijos	k O n k U r' E n' ts' I j o: s
konkurso	k O n k U r s o:
konkursų	k O n k U r s u:
konkursų	k O n k U r s u:
konsulato	k O n s U 5 A: t o:
konsultantei	k O n s U 5 t a n' t' EI
kontrabandines	k O n t r a b a n' d' I n' E s
korta	k O r t a
korta	k O r t a
kortelių	k O r' t' {: l' u:
kosmoso	k O s m O s o:
kovo	k o: v o:
kraštovaizdžiu	k r a S t o: v aI Z' dZ' U
kraštu	k r a S t U
kregždės	k r' {: g Z' d' e: s
kregždės	k r' E g Z' d' e: s
kreipsis	k r' EI p' s' I s
kreipė	k r' EI p' e:
krentančios	k r' E n t a n' tS' o: s
krepšininkų	k r' {: p' S' I n' I n k u:
krepšinio	k r' E p' S' I n' o:
krikščionys	k r' I k S' tS' o: n' i: s
kriminalinis	k r' I m' I n A: l' I n' I s
kriminalinės	k r' I m' I n A: l' I n' e: s
krizės	k r' I z' e: s
krizę	k r' I z' {:
krokodilai	k r O k O d' I 5 aI
kruizinio	k r U I z' I n' o:
kryptis	k r' i: p' t' I s
krūmą	k r u: m A:
krūmų	k r u: m u:
krūties	k r u: t' Ie s
krūvą	k r u: v A:
kultūra	k U 5 t u: r a
kultūra	k U 5 t u: r a
kultūriniai	k U 5 t u: r' I n' aI
kultūrų	k U 5 t u: r u:
kunigaikščio	k U n' I g aI k S' tS' o:
kunigas	k U n' I g a s
kuo	k UO
kupranugariai	k U p r a n U g A: r' aI
kur	k U r
kuri	k U r' I
kuriam	k U r' a m
kuriam	k U r' a m
kuriame	k U r' a m' E
kurioje	k U r' o: j E
kuris	k U r' I s
kurią	k U r' A:
kuro	k U r o:
kurį	k U r' i:
kvailystes	k v aI l' i: s' t' E s
kvailystes	k v aI l' i: s' t' E s
kvalifikuotos	k v a l' I f' I k UO t o: s
kviesdavo	k v' Ie z d a v o:
kviečiami	k v' Ie tS' a m' I
kylantis	k' i: 5 a n' t' I s
ką	k A:
kąsnio	k A: s' n' o:
kūriniai	k u: r' I n' aI
kūrėjai	k u: r' e: j aI
labai	5 a b aI
labiausiai	5 a b' aU s' aI
laboratorija	5 a b O r a t O r' I j a
laidos	5 aI d o: s
laidos	5 aI d o: s
laidos	5 aI d o: s
laikoma	5 aI k o: m a
laikomas	5 aI k o: m a s
laikomi	5 aI k o: m' I
laikyti	5 aI k' i: t' I
laiką	5 aI k A:
laikų	5 aI k u:
laimi	5 aI m' I
laimi	5 aI m' I
laimingesnė	5 aI m' I n' g' E s' n' e:
laimingesnę	5 aI m' I n' g' E s' n' {:
laimėjo	5 aI m' e: j o:
laimėjusi	5 aI m' e: j U s' I
laiptų	5 aI p t u:
laisvalaikiu	5 aI s v A: 5 aI k' U
laisve	5 aI s' v' E
laivo	5 aI v o:
laiškuose	5 aI S k UO s' E
lakią	5 A: k' A:
lango	5 a n g o:
lapai	5 A: p aI
lapeliai	5 a p' {: l' aI
lapkričio	5 A: p' k r' I tS' o:
lapus	5 a p U s
lauke	5 aU k' E
lauke	5 aU k' E
laukia	5 aU k' a
lauko	5 aU k o:
laukti	5 aU k t' I
laužo	5 aU Z o:
lazda	5 a z d a
ledai	l' E d aI
ledams	l' E d a m s
ledų	l' E d u:
legendų	l' E g' E n d u:
leidžia	l' EI dZ' a
leitenante	l' EI t' E n a n' t' E
lemia	l' {: m' a
lemiantis	l' {: m' a n' t' I s
lengviau	l' E n' g v' aU
lentynos	l' E n' t' i: n o: s
liberali	l' I b' E r a l' I
liepos	l' Ie p o: s
liepsnoje	l' Ie p s n o: j E
lietuvaičiai	l' E t U v aI tS' aI
lietuviai	l' Ie t U v' aI
lietuvių	l' Ie t U v' u:
liftus	l' I f t U s
liftus	l' I f t U s
link	l' I n k
linksma	l' I n k s m a
linksma	l' I n k s m a
linkę	l' I n' k' {:
litai	l' I t aI
litas	l' I t a s
literatūra	l' I t' E r a t u: r a
literatūra	l' I t' E r a t u: r a
literatūros	l' I t' E r a t u: r o: s
lito	l' I t o:
litų	l' I t u:
liudijimo	l' U d' I j I m o:
liūdnas	l' u: d n a s
lovą	5 o: v A:
lyderiai	l' i: d' E r' aI
lyderio	l' i: d' E r' o:
lyderė	l' i: d' E r' e:
lyg	l' i: k
lyg	l' i: k
lygiai	l' i: g' aI
lygis	l' i: g' I s
lygumų	l' i: g U m u:
lygumų	l' i: g U m u:
lyja	l' i: j a
lėktuvais	l' e: k t U v aI s
lėkštas	l' e: k S t a s
lėkštas	l' e: k S t a s
lėkštė	l' e: k S' t' e:
lėkštę	l' e: k S' t' {:
lėmė	l' e: m' e:
lūkesčius	5 u: k' E S' tS' U s
lūžta	5 u: S t a
mada	m a d a
mada	m A: d a
mados	m a d o: s
mados	m A: d o: s
magistre	m a g' I s' t' r' E
magistre	m a g' I s' t' r' E
mahajanistinio	m a G a j a n' I s' t' I n' o:
maistine	m aI s' t' I n' E
maistine	m aI s' t' I n' E
maisto	m aI s t o:
makiažas	m a k' I j A: Z a s
maloni	m a 5 o: n' I
malonu	m a 5 o: n U
malonumas	m a 5 o: n U m a s
malonumus	m a 5 o: n U m U s
malonumą	m a 5 o: n U m A:
man	m a n
manbase	m a n b a s' E
mano	m a n o:
mano	m A: n o:
manoma	m A: n o: m a
manęs	m a n' {: s
manęs	m A: n' {: s
marmuras	m a r m U r a s
maro	m A: r o:
masės	m A: s' e: s
matematikos	m a t' E m A: t' I k o: s
matuojami	m a t UO j a m' I
matyti	m a t' i: t' I
mače	m A: tS' E
mače	m a tS' E
mašinų	m a S' I n u:
mašinų	m A: S' I n u:
mažai	m a Z aI
mažai	m A: Z aI
mažas	m A: Z a s
maždaug	m a Z d aU k
mažiau	m a Z' aU
mažiau	m a Z' aU
mažiausiai	m a Z' aU s' aI
mažmena	m a Z' m' E n a
mažmena	m A: Z' m' E n a
mažą	m A: Z A:
medalius	m' E d a l' U s
medalius	m' E d A: l' U s
medicinos	m' E d' I ts' I n o: s
medienos	m' E d' Ie n o: s
meditacijas	m' E d' I t A: ts' I j a s
medžiaga	m' {: dZ' a g a
medžiaga	m' E dZ' a g a
medžiagą	m' {: dZ' a g A:
medžio	m' {: dZ' o:
medžių	m' {: dZ' u:
menininkę	m' {: n' I n' I n' k' {:
mergelę	m' E r' g' {: l' {:
mergina	m' E r' g' I n a
mergina	m' E r' g' I n a
mergina	m' E r' g' I n a
merginai	m' E r' g' I n aI
mes	m' {: s
mes	m' E s
metai	m' {: t aI
metais	m' {: t aI s
metalines	m' E t a l' I n' E s
metaliniai	m' E t a l' I n' aI
metaliniai	m' E t A: l' I n' aI
metikai	m' E t' I k aI
metu	m' E t U
metus	m' E t U s
metus	m' {: t U s
metų	m' {: t u:
miega	m' Ie g a
miega	m' Ie g a
miega	m' Ie g a
mielai	m' Ie 5 aI
mielai	m' Ie 5 aI
mieloji	m' Ie 5 o: j I
miestelio	m' Ie s' t' {: l' o:
miestelis	m' Ie s' t' {: l' I s
miesto	m' Ie s t o:
miestuose	m' Ie s t UO s' E
miestus	m' Ie s t U s
miestą	m' Ie s t A:
miestų	m' Ie s t u:
milijardais	m' I l' I j a r d aI s
milijardas	m' I l' I j a r d a s
milžiniškos	m' I l' Z' I n' I S k o: s
mineraliniai	m' I n' E r A: l' I n' aI
mineralinės	m' I n' E r A: l' I n' e: s
minima	m' I n' I m a
minima	m' I n' I m a
ministerija	m' I n' I s' t' E r' I j a
ministerijos	m' I n' I s' t' E r' I j o: s
ministras	m' I n' I s t r a s
minta	m' I n t a
minta	m' I n t a
minutė	m' I n U t' e:
minutės	m' I n U t' e: s
minučių	m' I n U tS' u:
minėta	m' I n' e: t a
miokardo	m' I j O k a r d o:
mirties	m' I r' t' Ie s
misiją	m' I s' I j A:
mišrųjį	m' I S r u: j i:
mobilieji	m O b' I l' Ie j I
mobilųjį	m O b' I 5 u: j i:
modelį	m O d' E l' i:
modernios	m O d' E r' n' o: s
modernios	m O d' E r' n' o: s
moka	m o: k a
mokesčių	m o: k' E S' tS' u:
mokiniai	m o: k' I n' aI
mokinys	m o: k' I n' i: s
mokomasi	m o: k o: m a s' I
moksleiviai	m o: k s' l' EI v' aI
mokslininkai	m o: k s' l' I n' I n k aI
mokslininko	m o: k s' l' I n' I n k o:
mokslininkus	m o: k s' l' I n' I n k U s
mokslinė	m o: k s' l' I n' e:
mokslo	m o: k s 5 o:
mokslu	m o: k s 5 U
mokyklas	m o: k' i: k 5 a s
mokykloje	m o: k' i: k 5 o: j E
mokyklų	m o: k' i: k 5 u:
mokytis	m o: k' i: t' I s
mokytojų	m o: k' i: t o: j u:
molis	m o: l' I s
moteris	m o: t' E r' I s
moterys	m o: t' E r' i: s
motociklais	m O t O ts' I k 5 aI s
motyvacija	m O t' i: v A: ts' I j a
mudu	m U d U
mus	m U s
muziejaus	m U z' Ie j aU s
muziejus	m U z' Ie j U s
muziejus	m U z' Ie j U s
muzika	m U z' I k a
muzikantu	m U z' I k a n t U
muzikos	m U z' I k o: s
mylimoji	m' i: l' I m o: j I
myliu	m' i: l' U
myliu	m' i: l' U
mąstymas	m A: s' t' i: m a s
mėginius	m' e: g' I n' U s
mėgstamiausia	m' e: k s t a m' aU s' a
mėgėjus	m' e: g' e: j U s
mėlyną	m' e: l' i: n A:
mėnesio	m' e: n' E s' o:
mėnesį	m' e: n' E s' i:
mėnuo	m' e: n UO
mėsa	m' e: s a
mėsa	m' e: s a
mūsų	m u: s u:
mūšio	m u: S' o:
nacionalinis	n a ts' I j O n A: l' I n' I s
nacionalinis	n a ts' O n A: l' I n' I s
nakties	n a k t' Ie s
naktį	n A: k t' i:
namo	n a m o:
namuose	n a m UO s' E
namus	n a m U s
namų	n a m u:
nanotechnologijos	n A: n O t' E x n O 5 O g' I j o: s
nario	n A: r' o:
narių	n a r' u:
narkotikus	n a r k O t' I k U s
natūralių	n a t u: r a l' u:
naudos	n aU d o: s
naudotojai	n aU d o: t o: j aI
naudą	n aU d A:
naudą	n aU d A:
nauja	n aU j a
nauja	n aU j a
naujas	n aU j a s
naujo	n aU j o:
naujomis	n aU j o: m' I s
naują	n aU j A:
naujų	n aU j u:
ne	n' E
neatitaisomos	n' E a t' I t aI s o: m o: s
neauga	n' E aU g a
nebeauga	n' E b' E aU g a
nebepavyksta	n' E b' E p a v' i: k s t a
nebežinodamas	n' E b' E Z' I n o: d a m a s
nebijo	n' E b' I j o:
neblizgios	n' E b' l' I z' g' o: s
neblizgios	n' E b' l' I z' g' o: s
nedidelio	n' E d' I d' E l' o:
nedidelės	n' E d' I d' E l' e: s
nedžabyk	n' E dZ A: b' i: k
negailėjo	n' E g aI l' e: j o:
negali	n' E g a l' I
negali	n' E g A: l' I
negalintys	n' E g A: l' I n' t' i: s
negalėjo	n' E g a l' e: j o:
negerai	n' E g' E r aI
negerai	n' E g' {: r aI
nei	n' EI
neišlaikyto	n' E I S 5 aI k' i: t o:
neišsipiltų	n' E I s' I p' I 5 t u:
neišsipiltų	n' E I s' I p' I 5 t u:
neišsipiltų	n' E I S' s' I p' I 5 t u:
neišsipiltų	n' E I S' s' I p' I 5 t u:
neklausysi	n' E k 5 aU s' i: s' I
neklaužadą	n' E k 5 aU Z a d A:
nekvalifikuotos	n' E k v a l' I f' I k UO t o: s
nekvėpavus	n' E k v' e: p A: v U s
nelaimes	n' E 5 aI m' E s
nelaimingam	n' E 5 aI m' I n g a m
nelaukiama	n' E 5 aU k' a m a
nelaukiama	n' E 5 aU k' a m a
neleidžia	n' E l' EI dZ' a
nematerialią	n' E m a t' E r' A: l' A:
nemačiusi	n' E m A: tS' U s' I
nemažai	n' E m A: Z aI
nemažai	n' E m a Z aI
nemiela	n' E m' Ie 5 a
nemiela	n' E m' Ie 5 a
nenaudojimu	n' E n aU d o: j I m U
nenori	n' E n o: r' I
nenori	n' E n o: r' I
neoklasicistiniai	n' E O k 5 a s' I ts' I s' t' I n' aI
nepagrįsti	n' E p a g r' i: s' t' I
nepagrįsti	n' E p a g r' i: s' t' I
nepakanka	n' E p a k a n k a
nepakankamai	n' E p a k a n k a m aI
nepamiršti	n' E p a m' I r' S' t' I
nepopuliari	n' E p O p U l' a r' I
nepriklausomybės	n' E p' r' I k 5 aU s o: m' i: b' e: s
nepriklausomybę	n' E p' r' I k 5 aU s o: m' i: b' {:
nepritaria	n' E p' r' I t a r a
neranda	n' E r a n d a
nereikalingas	n' E r' EI k a l' I n g a s
nereikalingų	n' E r' EI k a l' I n g u:
nereiklūs	n' E r' EI k 5 u: s
neretai	n' E r' E t aI
neretai	n' E r' {: t aI
nes	n' E s
neseniai	n' E s' E n' aI
neskelbs	n' E s' k' E 5 p s
nesugeba	n' E s U g' E b a
nesėkmės	n' E s' e: k m' e: s
nesėkmės	n' {: s' e: k m' e: s
net	n' E t
netiko	n' E t' I k o:
netikėtai	n' E t' I k' e: t aI
netrūksta	n' E t r u: k s t a
neturi	n' E t U r' I
neturi	n' E t U r' I
neturėjo	n' E t U r' e: j o:
neturėję	n' E t U r' e: j {:
neužsikrėstų	n' E U s' I k r' e: s t u:
neužsikrėstų	n' E U s' I k r' e: s t u:
neužsikrėstų	n' E U S' s' I k r' e: s t u:
neužsikrėstų	n' E U S' s' I k r' e: s t u:
nevidone	n' E v' I d o: n' E
neįmanoma	n' E i: m A: n o: m a
neįtikėtinų	n' E i: t' I k' e: t' I n u:
neįvykdymą	n' E i: v' i: g d' i: m A:
nešdami	n' E Z d a m' I
nešiausi	n' E S' aU s' I
nešini	n' E S' I n' I
nežinomoji	n' E Z' I n o: m o: j I
nežinomoji	n' E Z' I n o: m o: j I
niekada	n' Ie k a d a
niekaip	n' Ie k aI p
niekuo	n' Ie k UO
niūrokas	n' u: r o: k a s
noras	n o: r a s
norinčių	n o: r' I n' tS' u:
nors	n O r s
noru	n o: r U
noru	n o: r U
norėčiau	n o: r' e: tS' aU
nudraskė	n U d r A: s' k' e:
nudžabalijau	n U dZ a b A: l' I j aU
nudžabalijo	n U dZ a b A: l' I j o:
nudžabysiu	n U dZ A: b' i: s' U
nudžabyti	n U dZ A: b' i: t' I
nufilmuotas	n U f' I 5 m UO t a s
nugalėjo	n U g a l' e: j o:
nukentėjusiems	n U k' E n' t' e: j U s' Ie m s
nukritę	n U k r' I t' {:
nukrypsta	n U k r' i: p s t a
nulis	n U l' I s
numeris	n U m' E r' I s
numesti	n U m' E s' t' I
numesti	n U m' E s' t' I
numetęs	n U m' {: t' {: s
nuo	n UO
nuolat	n UO 5 a t
nuolat	n UO 5 a t
nuomones	n UO m o: n' E s
nuosavuose	n UO s a v UO s' E
nuosavą	n UO s a v A:
nuostabūs	n UO s t A: b u: s
nuostolius	n UO s t o: l' U s
nuotaikomis	n UO t aI k o: m' I s
nuotaikų	n UO t aI k u:
nuotykių	n UO t' i: k' u:
nusako	n U s A: k o:
nusifilmavusi	n U s' I f' I 5 m A: v U s' I
nusipelnė	n U s' I p' E l' n' e:
nusiperka	n U s' I p' E r k a
nusipirkti	n U s' I p' I r' k t' I
nusipirkti	n U s' I p' I r' k t' I
nusitrynusios	n U s' I t' r' i: n U s' o: s
nuslėpusiems	n U s' l' e: p U s' Ie m s
nusprendžiau	n U s' p' r' E n' dZ' aU
nuspręsta	n U s' p' r' {: s t a
nuspėjama	n U s' p' e: j a m a
nuspėjama	n U s' p' e: j a m a
nustatytas	n U s t a t' i: t a s
nustojo	n U s t o: j o:
nuvažiavome	n U v a Z' A: v o: m' E
nuveiktus	n U v' EI k t U s
nuveikus	n U v' EI k U s
nėra	n' e: r a
nūdienos	n u: d' E n o: s
nūdienos	n u: d' E n o: s
o	O
o	o:
objektas	O b' j E k t a s
objektas	O b' j E k t a s
objektyvių	O b' j E k t' i: v' u:
objektų	O b' j E k t u:
obuoliais	o: b UO l' aI s
odontologų	O d O n t O 5 O g u:
oficialiai	O f' I ts' I j a l' aI
oficialiai	O f' I ts' a l' aI
oi	OI
olimpiadoje	O l' I m' p' I j A: d o: j E
operacijos	O p' E r A: ts' I j o: s
opozicija	O p O z' I ts' I j a
orai	o: r aI
orams	o: r a m s
orda	O r d a
organizacijų	O r g a n' I z A: ts' I j u:
orkestro	O r' k' E s t r o:
oro	o: r o:
orą	o: r A:
paauglių	p a aU g l' u:
paauglystės	p a aU g l' i: s' t' e: s
pabrėžė	p a b' r' e: Z' e:
pacientas	p a ts' I E n t a s
padaryti	p a d a r' i: t' I
padarė	p a d A: r' e:
padaręs	p a d A: r' {: s
padeda	p a d' E d a
padidinti	p a d' I d' I n' t' I
padėjėjai	p a d' e: j e: j aI
padėkojome	p a d' e: k o: j o: m' E
padėtis	p a d' e: t' I s
padėtų	p a d' e: t u:
pagal	p A: g a 5
pagal	p a g a 5
pagalbą	p a g a 5 b A:
pagarsink	p a g a r' s' I n k
pagarsink	p a g a r' s' I n k
pagausėja	p a g aU s' e: j a
pagerbti	p a g' E r' p' t' I
pagerbti	p a g' E r' p' t' I
pagrindinio	p a g r' I n' d' I n' o:
pagrindinis	p a g r' I n' d' I n' I s
pagrindiniu	p a g r' I n' d' I n' U
pajėgumų	p a j e: g U m u:
pakaitalai	p a k aI t a 5 aI
pakankamai	p a k a n k a m aI
pakaunėje	p a k aU n' e: j E
pakiliomis	p a k' I l' o: m' I s
paklausa	p a k 5 aU s a
paklausos	p a k 5 aU s o: s
pakrantės	p a k r a n' t' e: s
pakrantėse	p a k r a n' t' e: s' E
pakrančių	p a k r a n' tS' u:
pakraščių	p a k r a S' tS' u:
palankių	p a 5 a n' k' u:
paleisti	p a l' EI s' t' I
paleisti	p a l' EI s' t' I
palikti	p a l' I k t' I
palikti	p a l' I k t' I
palydimas	p a l' i: d' I m a s
pamatę	p a m A: t' {:
pamestą	p a m' E s t A:
pametė	p a m' E t' e:
paminėjo	p a m' I n' e: j o:
paminėtas	p a m' I n' e: t a s
pamiršo	p a m' I r S o:
pamiršę	p a m' I r' S' {:
pamoka	p a m o: k a
panaikinti	p a n aI k' I n' t' I
panaudojimas	p a n aU d o: j I m a s
panaudojimą	p a n aU d o: j I m A:
panele	p a n' E l' E
panele	p a n' {: l' E
panelė	p a n' {: l' e:
papildomą	p a p' I 5 d o: m A:
paplitusios	p a p' l' I t U s' o: s
paplitęs	p a p' l' I t' {: s
paprasta	p a p r a s t a
paprasta	p a p r a s t a
paprastai	p a p r a s t aI
paprastai	p a p r a s t aI
paprašyti	p a p r a S' i: t' I
parama	p a r a m a
parama	p A: r a m a
parapijiečiai	p a r a p' I j Ie tS' aI
parašyti	p a r a S' i: t' I
parašė	p a r A: S' e:
pardavėjams	p a r d a v' e: j a m s
parduoti	p a r d UO t' I
parduoti	p a r d UO t' I
pareigūnams	p a r' EI g u: n a m s
parkas	p a r k a s
parke	p a r' k' E
parką	p a r k A:
paroda	p a r o: d a
parodyti	p a r o: d' i: t' I
paruošė	p a r UO S' e:
pas	p a s
pasakiau	p a s a k' aU
pasakojo	p A: s a k o: j o:
pasakykite	p a s a k' i: k' I t' E
pasakėme	p a s A: k' e: m' E
pasauliniam	p a s aU l' I n' a m
pasaulio	p a s aU l' o:
pasaulis	p a s aU l' I s
pasaulyje	p a s aU l' i: j E
pasaulį	p a s aU l' i:
pasekmes	p A: s' E k m' E s
pasibaigus	p a s' I b aI g U s
pasiekia	p a s' Ie k' a
pasieksite	p a s' Ie k s' I t' E
pasikeitusi	p a s' I k' EI t U s' I
pasiklysta	p a s' I k l' i: s t a
pasimėgauti	p a s' I m' e: g aU t' I
pasipuošęs	p a s' I p UO S' {: s
pasirodo	p a s' I r o: d o:
pasirodė	p a s' I r o: d' e:
pasirodęs	p a s' I r o: d' {: s
pasisako	p a s' I s A: k o:
pasisekimo	p a s' I s' E k' I m o:
pasitarsime	p a s' I t a r' s' I m' E
pasitinka	p a s' I t' I n k a
pasitraukė	p a s' I t r aU k' e:
pasivažinėti	p a s' I v a Z' I n' e: t' I
pasiūla	p a s' u: 5 a
pasižymi	p a s' I Z' i: m' I
pasižymi	p a s' I Z' i: m' I
pasižymėjo	p a s' I Z' i: m' e: j o:
paskatintas	p a s k A: t' I n t a s
paskirtį	p A: s' k' I r' t' i:
paskutiniai	p a s k U t' I n' aI
paskutiniam	p a s k U t' I n' a m
paskutiniame	p a s k U t' I n' a m' E
paslaptis	p a s 5 a p' t' I s
paslaptis	p A: s 5 a p' t' I s
pastabus	p a s t a b U s
pastaruoju	p a s t a r UO j U
pastatyta	p a s t a t' i: t a
pastatyti	p a s t a t' i: t' I
pat	p a t
patikimi	p a t' I k' I m' I
patikimumą	p a t' I k' I m U m A:
patikėtas	p a t' I k' e: t a s
patiriame	p a t' I r' a m' E
patogeniškumo	p a t O g' E n' I S k U m o:
patogesnėmis	p a t o: g' E s' n' e: m' I s
patyrė	p a t' i: r' e:
patys	p A: t' i: s
paukštiena	p aU k S' t' Ie n a
paukštienos	p aU k S' t' Ie n o: s
paukščius	p aU k S' tS' U s
paukščių	p aU k S' tS' u:
pavadintas	p a v a d' I n t a s
pavartotas	p a v a r t o: t a s
paversti	p a v' E r' s' t' I
paversti	p a v' E r' s' t' I
paviešėję	p a v' Ie S' e: j {:
paviršiaus	p a v' I r' S' aU s
pavojingiausių	p a v o: j I n' g' aU s' u:
pavyko	p a v' i: k o:
pavyzdys	p a v' i: z' d' i: s
pačiais	p a tS' aI s
pačiame	p a tS' a m' E
pačios	p a tS' o: s
pačios	p A: tS' o: s
pašalpas	p A: S a 5 p a s
pašnekovą	p a S' n' E k o: v A:
pašvaistės	p a S v aI s' t' e: s
pažeidžiama	p a Z' EI dZ' a m a
pažeidžiama	p a Z' EI dZ' a m a
pažeidžiant	p a Z' EI dZ' a n t
pažymėti	p a Z' i: m' e: t' I
peiliai	p' EI l' aI
peiliu	p' EI l' U
peizažais	p' EI z A: Z aI s
pendešimt	p' E n' d' E S' I m t
penki	p' E n' k' I
penkias	p' E n' k' a s
penkiasdešimt	p' E n' k' a z' d' {: S' I m t
penkiasdešimt	p' E n' k' a z' d' {: S' I m t
penkiasdešimtųjų	p' E n' k' a z' d' {: S' I m t u: j u:
penkiasdešimtųjų	p' E n' k' a z' d' E S' I m t u: j u:
penkiolika	p' E n' k' o: l' I k a
penkiolikta	p' E n' k' o: l' I k t a
penkioliktoji	p' E n' k' o: l' I k t o: j I
penkios	p' E n' k' o: s
penkių	p' E n' k' u:
penkta	p' E n k t a
penkta	p' E n k t a
penktadienis	p' E n k t A: d' Ie n' I s
penkti	p' E n' k t' I
penktų	p' E n k t u:
penktųjų	p' E n k t u: j u:
penkšimt	p' E n' k S' I m t
pensijų	p' E n' s' I j u:
per	p' E r
pergale	p' E r g a l' E
pergalė	p' E r g a l' e:
pergyvena	p' E r' g' i: v' E n a
perkamo	p' E r k a m o:
perkelti	p' E r' k' E l' t' I
perlenkiama	p' E r' l' E n' k' a m a
perlui	p' E r 5 Ui
pernai	p' E r n aI
perplaukę	p' E r p 5 aU k' {:
perskaityta	p' E r s k aI t' i: t a
perspėjo	p' E r' s' p' e: j o:
pertraukiantis	p' E r t r aU k' a n' t' I s
pertvarka	p' E r t v a r k a
picų	p' I ts u:
pieninė	p' Ie n' I n' e:
pietų	p' Ie t u:
pietų	p' Ie t u:
pigesnę	p' I g' E s' n' {:
pigi	p' I g' I
piktnaudžiavimu	p' I k t n aU dZ' A: v' I m U
piliečiai	p' I l' Ie tS' aI
pin	p' I n
piniginė	p' I n' I g' I n' e:
pinigus	p' I n' I g U s
pinigų	p' I n' I g u:
pirma	p' I r m a
pirma	p' I r m a
pirmadienis	p' I r m A: d' Ie n' I s
pirmasis	p' I r m a s' I s
pirmi	p' I r' m' I
pirmo	p' I r m o:
pirmoji	p' I r m o: j I
pirmos	p' I r m o: s
pirmos	p' I r m o: s
pirmą	p' I r m A:
pirmų	p' I r m u:
pirmųjų	p' I r m u: j u:
piršliai	p' I r' S' l' aI
pjauna	p' j aU n a
plakatai	p 5 a k A: t aI
planetai	p 5 a n' E t aI
planetą	p 5 a n' E t A:
planšetinių	p 5 a n' S' E t' I n' u:
plieno	p' l' Ie n o:
plius	p' l' U s
pluoštų	p 5 UO S t u:
plėtojo	p' l' e: t o: j o:
plėtoti	p' l' e: t o: t' I
plūsta	p 5 u: s t a
po	p o:
pobūdžio	p o: b u: dZ' o:
poilsiautojai	p o: I l' s' aU t o: j aI
poilsiavo	p o: I l' s' A: v o:
pokalbiai	p o: k a l' b' aI
policija	p o: l' I ts' I j a
policijos	p o: l' I ts' I j o: s
policiją	p O l' I ts' I j A:
policininkai	p o: l' I ts' I n' I n k aI
policininkų	p O l' I ts' I n' I n k u:
politikoje	p O l' I t' I k o: j E
politikų	p O l' I t' I k u:
politinė	p O l' I t' I n' e:
pone	p o: n' E
popierinius	p o: p' Ie r' I n' U s
popierinius	p o: p' Ie r' I n' U s
populiacija	p O p U l' A: ts' I j a
porcija	p O r' ts' I j a
porciją	p O r' ts' I j A:
poreikį	p o: r' EI k' i:
portaluose	p O r t A: 5 UO s' E
poryt	p o: r' i: t
posėdžio	p o: s' e: dZ' o:
pozicijas	p O z' I ts' I j a s
požymis	p o: Z' i: m' I s
prabilta	p r a b' I 5 t a
pradingo	p r a d' I n g o:
pradėjo	p r a d' e: j o:
pradėjusi	p r a d' e: j U s' I
pradės	p r a d' e: s
pradėti	p r a d' e: t' I
pradėti	p r a d' e: t' I
pradžia	p r a dZ' a
pradžioje	p r a dZ' o: j E
pradžiugino	p r a dZ' U g' I n o:
pradžią	p r A: dZ' A:
prakilnybe	p r a k' I l' n' i: b' E
pramoga	p r a m o: g a
prancūzai	p r a n ts u: z aI
prancūziški	p r a n ts u: z' I S' k' I
prancūzų	p r a n ts u: z u:
pranoko	p r a n o: k o:
praraja	p r a r a j a
praraja	p r A: r a j a
prasidėjus	p r a s' I d' e: j U s
prastesnė	p r a s' t' E s' n' e:
pratęsimo	p r a t' {: s' I m o:
praūžę	p r a u: Z' {:
premjeras	p' r' E m' I j E r a s
premjeras	p' r' E m' j E r a s
prezidentas	p' r' E z' I d' E n t a s
prezidentas	p' r' E z' I d' E n t a s
prezidento	p' r' E z' I d' E n t o:
prezidentė	p' r' E z' I d' E n' t' e:
prezidentė	p' r' E z' I d' E n' t' e:
prie	p' r' Ie
priemone	p' r' Ie m o: n' E
priemonių	p' r' Ie m o: n' u:
prieteli	p' r' Ie t' E l' I
prieš	p' r' Ie S
priešraketinės	p' r' Ie S r a k' E t' I n' e: s
priežasčių	p' r' Ie Z a S' tS' u:
priežiūra	p' r' Ie Z' u: r a
prigrūsta	p' r' I g r u: s t a
prigrūsta	p' r' I g r u: s t a
priklauso	p' r' I k 5 aU s o:
primena	p' r' I m' E n a
priminė	p' r' I m' I n' e:
pripažino	p' r' I p a Z' I n o:
pripažintais	p' r' I p a Z' I n t aI s
pripažintais	p' r' I p a Z' I n t aI s
pripažinti	p' r' I p a Z' I n' t' I
pripažinti	p' r' I p a Z' I n' t' I
prirašyta	p' r' I r a S' i: t a
prireikė	p' r' I r' EI k' e:
prisidėję	p' r' I s' I d' e: j {:
prisikėlimo	p' r' I s' I k' e: l' I m o:
prisitraukti	p' r' I s' I t r aU k t' I
prisitraukti	p' r' I s' I t r aU k t' I
pristatomas	p' r' I s t A: t o: m a s
pristatyti	p' r' I s t a t' i: t' I
pristatė	p' r' I s t A: t' e:
privatumo	p' r' I v a t U m o:
privačių	p' r' I v a tS' u:
priversti	p' r' I v' E r' s' t' I
priversti	p' r' I v' E r' s' t' I
priverčia	p' r' I v' E r' tS' a
prizas	p' r' I z a s
probiotikai	p r O b' I j O t' I k aI
problemų	p r O b' l' E m u:
procedūros	p r O ts' E d u: r o: s
procedūrų	p r O ts' E d u: r u:
procentai	p r O ts' E n t aI
procentai	p r O ts' E n t aI
procentų	p r O ts' E n t u:
procentų	p r O ts' E n t u:
produkcijoje	p r O d U k ts' I j o: j E
produktyvesnį	p r O d U k t' i: v' E s' n' i:
produktų	p r O d U k t u:
produktų	p r O d U k t u:
profesijų	p r O f' E s' I j u:
profesionalai	p r O f' E s' O n A: 5 aI
profesionalais	p r O f' E s' O n A: 5 aI s
profesionalų	p r O f' E s' O n A: 5 u:
prognozuojamas	p r O g n O z UO j a m a s
programa	p r O g r a m a
programoje	p r O g r A: m o: j E
programą	p r O g r A: m A:
projektais	p r O j E k t aI s
protestas	p r O t' E s t a s
protestas	p r O t' E s t a s
provincijoje	p r O v' I n' ts' I j o: j E
provincijos	p r O v' I n' ts' I j o: s
proziniai	p r O z' I n' aI
publikaciją	p U b' l' I k A: ts' I j A:
puikiai	p Ui k' aI
puikių	p Ui k' u:
pusė	p U s' e:
pusėje	p U s' e: j E
pusės	p U s' e: s
pusę	p U s' {:
pėdsekį	p' e: t' s' E k' i:
radarą	r a d A: r A:
radiją	r A: d' I j A:
raidė	r aI d' e:
raidė	r aI d' e:
raiteliai	r aI t' E l' aI
rajono	r a j O n o:
rajonų	r a j O n u:
raketas	r a k' E t a s
raketas	r a k' E t a s
ramios	r a m' o: s
ramios	r A: m' o: s
raudona	r aU d o: n a
raudona	r aU d o: n a
raudonų	r aU d o: n u:
raudonų	r aU d o: n u:
rašytojai	r a S' i: t o: j aI
rašytojas	r a S' i: t o: j a s
reakcijomis	r' E A: k ts' I j o: m' I s
reakciją	r' E A: k ts' I j A:
realizavusi	r' E a l' I z A: v U s' I
reanimacijoje	r' E a n' I m A: ts' I j o: j E
recesija	r' E ts' E s' I j a
referendumui	r' E f' E r' E n d U m Ui
reformos	r' E f O r m o: s
regiono	r' E g' I j O n o:
regionų	r' E g' I j O n u:
reglamentuota	r' E g 5 a m' E n t UO t a
reikalavimus	r' EI k a 5 A: v' I m U
reikalavimų	r' EI k a 5 A: v' I m u:
reikia	r' EI k' a
reiškiniai	r' EI S' k' I n' aI
reklaminis	r' E k 5 A: m' I n' I s
reklamą	r' E k 5 A: m A:
rekonstruoti	r' E k O n s t r UO t' I
reliatyvizmo	r' E l' a t' i: v' I z m o:
remiantys	r' {: m' a n' t' i: s
renginyje	r' E n' g' I n' i: j E
reprezentacines	r' E p' r' E z' E n t A: ts' I n' E s
reta	r' E t a
reta	r' {: t a
revanšiškų	r' E v a n' S' I S k u:
rezultatų	r' E z U 5 t A: t u:
rečiau	r' E tS' aU
riaušių	r' aU S' u:
ribos	r' I b o: s
ribos	r' I b o: s
ribų	r' I b u:
rimtą	r' I m t A:
rinkimai	r' I n' k' I m aI
rinkimų	r' I n' k' I m u:
rinkosi	r' I n k o: s' I
rinktinės	r' I n' k t' I n' e: s
riterių	r' I t' E r' u:
rizika	r' I z' I k a
rizikingesniems	r' I z' I k' I n' g' E s' n' Ie m s
rizikuoti	r' I z' I k UO t' I
riziką	r' I z' I k A:
robotą	r O b O t A:
rodė	r o: d' e:
rožėmis	r o: Z' e: m' I s
rudens	r U d' E n s
rugpjūtį	r U k p' j u: t' i:
rugpjūčio	r U k p' j u: tS' o:
rugsėjo	r U k s' e: j o:
rungtyse	r U n' k t' i: s' E
ruošti	r UO S' t' I
ruošti	r UO S' t' I
rykliai	r' i: k l' aI
rytas	r' i: t a s
rytinės	r' i: t' I n' e: s
ryto	r' i: t o:
rytoj	r' i: t O j
rytuose	r' i: t UO s' E
ryškiaspalviai	r' i: S' k' a s p a l' v' aI
ryškiausias	r' i: S' k' aU s' a s
ryšys	r' i: S' i: s
rūmai	r u: m aI
rūmais	r u: m aI s
rūšis	r u: S' I s
sakiniai	s a k' I n' aI
saldikliai	s a l' d' I k l' aI
saloje	s a 5 o: j E
samprata	s a m p r a t a
sanitarinių	s a n' I t A: r' I n' u:
santykį	s a n' t' i: k' i:
sapnas	s A: p n a s
saugia	s aU g' a
sausio	s aU s' o:
sausros	s aU s r o: s
sausros	s aU s r o: s
savaitgaliui	s a v aI d g a l' Ui
savaitgalį	s a v aI d g a l' i:
savaitę	s a v aI t' {:
savarankiškai	s a v a r a n' k' I S k aI
savavališkai	s a v a v A: l' I S k aI
save	s a v' E
savimi	s a v' I m' I
savitu	s A: v' I t U
savivaldos	s a v' I v a 5 d o: s
savo	s a v o:
savybių	s a v' i: b' u:
savybėmis	s a v' i: b' e: m' I s
savyje	s a v' i: j E
savąja	s a v A: j a
scenarijus	s' ts' E n A: r' I j U s
seilių	s' EI l' u:
sekmadienis	s' E k m A: d' Ie n' I s
sekmadienį	s' E k m A: d' Ie n' i:
sektinas	s' E k t' I n a s
sektoriams	s' E k t O r' a m s
sektoriaus	s' E k t O r' aU s
sektorius	s' E k t O r' U s
sekundes	s' E k U n' d' E s
seminaras	s' E m' I n A: r a s
seniausieji	s' E n' aU s' Ie j I
seniausių	s' E n' aU s' u:
seniūnui	s' E n' u: n Ui
senovinės	s' E n o: v' I n' e: s
senovės	s' E n o: v' e: s
senu	s' E n U
senutė	s' E n U t' e:
senėja	s' E n' e: j a
senų	s' E n u:
septinta	s' E p' t' I n t a
septintais	s' E p' t' I n t aI s
septinti	s' E p' t' I n' t' I
septintoji	s' E p' t' I n t o: j I
septintą	s' E p' t' I n t A:
septintų	s' E p' t' I n t u:
septintųjų	s' E p' t' I n t u: j u:
septyni	s' E p' t' i: n' I
septyniasdešimt	s' E p' t' i: n' a z' d' {: S' I m t
septyniasdešimtų	s' E p' t' i: n' a z' d' E S' I m t u:
septyniasdešimtųjų	s' E p' t' i: n' a z' d' E S' I m t u: j u:
septyniolika	s' E p' t' i: n' o: l' I k a
septyniolikos	s' E p' t' i: n' o: l' I k o: s
septyniolikta	s' E p' t' i: n' o: l' I k t a
septynios	s' E p' t' i: n' o: s
septynis	s' E p' t' i: n' I s
septynių	s' E p' t' i: n' u:
septynių	s' E p' t' i: n' u:
serbentų	s' E r' b' E n t u:
servisas	s' E r' v' I s a s
sesijos	s' E s' I j o: s
sezamai	s' E z A: m aI
sezoninio	s' E z O n' I n' o:
sezoniškumas	s' E z O n' I S k U m a s
si	s' I
siaurose	s' aU r o: s' E
siautėjęs	s' aU t' e: j {: s
sieja	s' Ie j a
sieja	s' Ie j a
siekė	s' Ie k' e:
sielą	s' Ie 5 A:
sienų	s' Ie n u:
simbolinę	s' I m b O l' I n' {:
simboliu	s' I m b O l' U
simbolizavo	s' I m b O l' I z A: v o:
sionalais	s' I j O n A: 5 aI s
sistema	s' I s' t' E m a
sistemos	s' I s' t' E m o: s
situacijoje	s' I t U A: ts' I j o: j E
situacijos	s' I t U A: ts' I j o: s
siūlo	s' u: 5 o:
siūlome	s' u: 5 o: m' E
siųsdavo	s' u: z d a v o:
skaitmeniniu	s k aI t' m' E n' I n' U
skaito	s k aI t o:
skaitymas	s k aI t' i: m a s
skaitytojai	s k aI t' i: t o: j aI
skaičius	s k aI tS' U s
skaičius	s k aI tS' U s
skalūninių	s k a 5 u: n' I n' u:
skandinavų	s k a n' d' I n A: v u:
skaudžiausios	s k aU dZ' aU s' o: s
skelbimas	s' k' E l' b' I m a s
skelbtą	s' k' E 5 p t A:
skiriamas	s' k' I r' a m a s
skirta	s' k' I r t a
skirtas	s' k' I r t a s
skirtas	s' k' I r t a s
skirtas	s' k' I r t a s
skirtumai	s' k' I r t U m aI
sklandžiai	s k 5 a n' dZ' aI
skola	s k o: 5 a
skola	s k o: 5 a
skolintojams	s k o: l' I n t o: j a m s
skolą	s k o: 5 A:
skurdžioj	s k U r' dZ' O j
skylė	s' k' i: l' e:
skylė	s' k' i: l' e:
skyriaus	s' k' i: r' aU s
skyriaus	s' k' i: r' aU s
skyrius	s' k' i: r' U s
skyrius	s' k' i: r' U s
skųsdavosi	s k u: z d a v o: s' I
sloga	s 5 o: g a
sloga	s 5 o: g a
smagiose	s m a g' o: s' E
smerkia	s' m' E r' k' a
smilčių	s' m' I l' tS' u:
smilčių	s' m' I l' tS' u:
smulkmenas	s m U l' k m' E n a s
smulkmenomis	s m U l' k m' E n o: m' I s
smulkus	s m U 5 k U s
smurto	s m U r t o:
smėlis	s' m' e: l' I s
socialinis	s O ts' I j A: l' I n' I s
socialinis	s O ts' A: l' I n' I s
socialinė	s O ts' I j A: l' I n' e:
socialinė	s O ts' A: l' I n' e:
socialinės	s O ts' I j A: l' I n' e: s
socialinės	s O ts' A: l' I n' e: s
socialinį	s O ts' I j A: l' I n' i:
socialinį	s O ts' A: l' I n' i:
socialistinis	s O ts' I j a l' I s' t' I n' I s
socialistinis	s O ts' a l' I s' t' I n' I s
soda	s O d a
soda	s O d a
sode	s o: d' E
sode	s o: d' E
sodo	s o: d o:
sofistų	s O f' I s t u:
sostinė	s o: s' t' I n' e:
spalio	s p A: l' o:
spalvos	s p a 5 v o: s
spalvos	s p a 5 v o: s
sparčiai	s p a r' tS' aI
sparčiai	s p a r' tS' aI
specialiojoje	s' p' E ts' I j a l' o: j o: j E
specialiojoje	s' p' E ts' a l' o: j o: j E
specialistai	s' p' E ts' I j a l' I s t aI
specialistai	s' p' E ts' a l' I s t aI
specialistė	s' p' E ts' I j a l' I s' t' e:
specialistė	s' p' E ts' a l' I s' t' e:
specialistų	s' p' E ts' I j a l' I s t u:
specialistų	s' p' E ts' a l' I s t u:
specialų	s' p' E ts' I j A: 5 u:
specialų	s' p' E ts' A: 5 u:
specifinis	s' p' E ts' I f' I n' I s
sportas	s p O r t a s
sporto	s p O r t o:
sportuodami	s p O r t UO d a m' I
sprendimų	s' p' r' E n' d' I m u:
sprogimą	s p r o: g' I m A:
srities	s' r' I t' Ie s
sritis	s' r' I t' I s
staigmenas	s t aI g m' E n a s
staigmenų	s t aI g m' E n u:
stambus	s t a m b U s
statinys	s t a t' I n' i: s
statusą	s t A: t U s A:
statyba	s t a t' i: b a
statybininkai	s t a t' i: b' I n' I n k aI
statybinio	s t a t' i: b' I n' o:
statybos	s t a t' i: b o: s
stebimas	s' t' {: b' I m a s
stebinančiomis	s' t' {: b' I n a n' tS' o: m' I s
stebėjome	s' t' E b' e: j o: m' E
stengiamasi	s' t' E n' g' a m a s' I
stiklu	s' t' I k 5 U
stipriausias	s' t' I p' r' aU s' a s
stiprus	s' t' I p r U s
stovyklos	s t o: v' i: k 5 o: s
stovėjo	s t o: v' e: j o:
streiko	s' t' r' EI k o:
stresas	s' t' r' E s a s
studente	s t U d' E n' t' E
su	s U
substanciją	s U p s t a n' ts' I j A:
sudaro	s U d A: r o:
sudaroma	s U d A: r o: m a
sudurti	s U d U r' t' I
sudurti	s U d U r' t' I
sudzingėjo	s U dz' I n' g' e: j o:
sugebėjau	s U g' E b' e: j aU
sugriežtino	s U g r' Ie S' t' I n o:
sukauptų	s U k aU p t u:
sukauptų	s U k aU p t u:
sukilėlių	s U k' I l' e: l' u:
sukti	s U k t' I
sukti	s U k t' I
sukurti	s U k U r' t' I
sukurti	s U k U r' t' I
sukėlė	s U k' e: l' e:
sukūrė	s U k u: r' e:
sulaikytas	s U 5 aI k' i: t a s
sulaukė	s U 5 aU k' e:
sulaukę	s U 5 aU k k' {:
sumažinti	s U m A: Z' I n' t' I
sumažėjo	s U m a Z' e: j o:
sumą	s U m A:
sunkus	s U n k U s
suorganizavo	s U O r g a n' I z A: v o:
supranta	s U p r a n t a
surado	s U r A: d o:
surengtas	s U r' E n k t a s
surengė	s U r' E n' g' e:
susiaurėjo	s U s' aU r' e: j o:
susidariusi	s U s' I d A: r' U s' I
susierzinimą	s U s' I E r' z' I n' I m A:
susiformavo	s U s' I f O r m A: v o:
susiformuoja	s U s' I f O r m UO j a
susikaupti	s U s' I k aU p' t' I
susimeistravo	s U s' I m' EI s t r A: v o:
susimąstyti	s U s' I m A: s' t' i: t' I
susipažino	s U s' I p a Z' I n o:
susirinkusieji	s U s' I r' I n k U s' Ie j I
susituokę	s U s' I t UO k' {:
suspėti	s U s' p' e: t' I
suspėti	s U s' p' e: t' I
sustojo	s U s t o: j o:
susėdę	s U s' e: d' {:
sutarties	s U t a r' t' Ie s
sutartis	s U t a r' t' I s
sutartis	s U t a r' t' I s
suteikia	s U t' EI k' a
sutikti	s U t' I k t' I
sutikti	s U t' I k t' I
sutiktų	s U t' I k t u:
sutiktų	s U t' I k t u:
sutuoktinių	s U t UO k t' I n' u:
suvaidino	s U v aI d' I n o:
suvaldyti	s U v a l' d' i: t' I
suvienyti	s U v' Ie n' i: t' I
sužadina	s U Z A: d' I n a
svajoja	s v a j o: j a
svarbaus	s v a r b aU s
svarbesne	s v a r' b' E s' n' E
svarbiausios	s v a r' b' aU s' o: s
svarbą	s v a r b A:
svarbūs	s v a r b u: s
sveikatos	s' v' EI k A: t o: s
sveikatą	s' v' EI k A: t A:
sveikiems	s' v' EI k' Ie m s
sveikino	s' v' EI k' I n o:
svetainės	s' v' E t aI n' e: s
svečiai	s' v' E tS' aI
sąžiningai	s A: Z' I n' I n g aI
sėdint	s' e: d' I n t
sėkmę	s' e: k m' {:
sūnus	s u: n U s
sūnus	s u: n U s
ta	t a
tad	t a d
tai	t aI
tai	t aI
taip	t aI p
tais	t aI s
taisyklingai	t aI s' i: k l' I n g aI
talpinamas	t a l' p' I n a m a s
tam	t a m
tam	t a m
tampa	t a m p a
tampri	t a m' p' r' I
tarnautojų	t a r n aU t o: j u:
tarp	t a r p
tarpu	t a r p U
tarpusavyje	t a r p U s a v' i: j E
taryba	t a r' i: b a
tarėsi	t A: r' e: s' I
tau	t aU
taupyti	t aU p' i: t' I
taurės	t aU r' e: s
taurės	t aU r' e: s
taurę	t aU r' {:
tačiau	t a tS' aU
teatras	t' E A: t r a s
teatre	t' E a t' r' E
teatre	t' E A: t' r' E
tebeauga	t' E b' E aU g a
tebegalioja	t' E b' E g a l' o: j a
technologijos	t' E x n O 5 O g' I j o: s
teigia	t' EI g' a
teigiamas	t' EI g' a m a s
teikimu	t' EI k' I m U
teisėjai	t' EI s' e: j aI
teisėjų	t' EI s' e: j u:
teisėsaugininkų	t' EI s' e: s aU g' I n' I n k u:
teko	t' {: k o:
telefonai	t' E l' E f O n aI
telefonai	t' E l' E f O n aI
telefono	t' E l' E f O n o:
telefono	t' E l' E f O n o:
telefoną	t' E l' E f O n A:
telefoną	t' E l' E f O n A:
televizijos	t' E l' E v' I z' I j o: s
televizinius	t' E l' E v' I z' I n' U s
telkinių	t' E l' k' I n' u:
telkšo	t' E 5 k S o:
terminų	t' E r' m' I n u:
tiek	t' Ie k
tiesioginę	t' Ie s' o: g' I n' {:
tik	t' I k
tikrai	t' I k r aI
tikrai	t' I k r aI
tikrinimo	t' I k r' I n' I m o:
tikrinti	t' I k r' I n' t' I
tikslas	t' I k s 5 a s
tikslus	t' I k s 5 U s
tilto	t' I 5 t o:
tinka	t' I n k a
tinkamos	t' I n k a m o: s
tinkamos	t' I n k a m o: s
tirti	t' I r' t' I
tirti	t' I r' t' I
tituluojamas	t' I t U 5 UO j a m a s
to	t o:
tobulėkime	t o: b U l' e: k' I m' E
todėl	t o: d' e: 5
tokioje	t o: k' o: j E
toks	t o: k s
tokį	t o: k' i:
toli	t o: l' I
toli	t o: l' I
tolimą	t o: l' I m A:
tolimą	t o: l' I m A:
tolimų	t o: l' I m u:
tornadas	t O r n A: d a s
tortų	t O r t u:
tradiciniam	t r a d' I ts' I n' a m
tradiciškai	t r a d' I ts' I S k aI
trajektorija	t r a j E k t O r' I j a
transporto	t r a n s p O r t o:
transporto	t r a n s p O r t o:
traukinius	t r aU k' I n' U s
traukos	t r aU k o: s
treneri	t' r' E n' E r' I
treti	t' r' E t' I
trečia	t' r' E tS' a
trečiadienis	t' r' E tS' A: d' Ie n' I s
trečiasis	t' r' E tS' a s' I s
trečio	t' r' {: tS' o:
trečių	t' r' E tS' u:
trečiųjų	t' r' E tS' u: j u:
trijų	t' r' I j u:
trijų	t' r' I j u:
trisdešimt	t' r' I z' d' E S' I m t
trisdešimta	t' r' I z' d' E S' I m t a
trisdešimtoji	t' r' I z' d' E S' I m t o: j I
trisdešimtų	t' r' I z' d' E S' I m t u:
triukšmu	t' r' U k S m U
trolį	t r O l' i:
trylika	t' r' i: l' I k a
trylikta	t' r' i: l' I k t a
tryliktą	t' r' i: l' I k t A:
trys	t' r' i: s
trūkumas	t r u: k U m a s
tu	t U
tuo	t UO
turi	t U r' I
turi	t U r' I
turime	t U r' I m' E
turintys	t U r' I n' t' i: s
turinčiais	t U r' I n' tS' aI s
turnyrą	t U r' n' i: r A:
turtuolių	t U r t UO l' u:
turėjo	t U r' e: j o:
turės	t U r' e: s
turėti	t U r' e: t' I
turėtų	t U r' e: t u:
tvarka	t v a r k a
tvarka	t v a r k a
tvarką	t v a r k A:
tyliai	t' i: l' aI
tyrimai	t' i: r' I m aI
tyrimai	t' i: r' I m aI
tyrimo	t' i: r' I m o:
tyrimo	t' i: r' I m o:
tyrimus	t' i: r' I m U s
tyrė	t' i: r' e:
tyrė	t' i: r' e:
tyrė	t' i: r' e:
tą	t A:
tėkmės	t' e: k m' e: s
tėkmės	t' e: k m' e: s
tėvai	t' e: v aI
tėvų	t' e: v u:
tūkstantieji	t u: k s t a n' t' Ie j I
tūkstantis	t u: k s t a n' t' I s
tūkstančiai	t u: k s t a n' tS' aI
tūkstančių	t u: k s t a n' tS' u:
ugdymo	U g d' i: m o:
unikalia	U n' I k a l' a
unikalų	U n' I k A: 5 u:
uostas	UO s t a s
uostas	UO s t a s
uoste	UO s' t' E
upelių	U p' {: l' u:
upių	U p' u:
urmas	U r m a s
už	U Z
užaugo	U Z aU g o:
užbaigimą	U Z b aI g' I m A:
užfiksavo	U Z' f' I k s A: v o:
užfiksuoti	U Z' f' I k s UO t' I
užima	U Z' I m a
užkimimas	U S' k' I m' I m a s
užkliuvo	U S' k l' U v o:
užlieja	U Z' l' Ie j a
užmesti	U Z' m' E s' t' I
užmesti	U Z' m' E s' t' I
užmigusį	U Z' m' I g U s' i:
užrašuose	U Z r a S UO s' E
užsieniečiai	U s' Ie n' Ie tS' aI
užsieniečiai	U S' s' Ie n' Ie tS' aI
užsieniečius	U s' Ie n' Ie tS' U s
užsieniečius	U S' s' Ie n' Ie tS' U s
užsieniečius	U s' Ie n' Ie tS' U s
užsieniečius	U S' s' Ie n' Ie tS' U s
užsienio	U s' Ie n' o:
užsiima	U s' I I m a
užsitarnavo	U s' I t a r n A: v o:
užsitarnavo	U S' s' I t a r n A: v o:
užsitęsusios	U s' I t' {: s U s' o: s
užsitęsusios	U S' s' I t' {: s U s' o: s
užvakar	U Z v A: k a r
vabzdžiai	v a b' Z' dZ' aI
vadinama	v a d' I n a m a
vadinamas	v a d' I n a m a s
vadinami	v a d' I n a m' I
vadovas	v a d o: v a s
vadove	v a d o: v' E
vadybos	v a d' i: b o: s
vagį	v A: g' i:
vaidina	v aI d' I n a
vaidinimas	v aI d' I n' I m a s
vaidmens	v aI d' m' E n s
vaikai	v aI k aI
vaikaičius	v aI k aI tS' U s
vaikas	v aI k a s
vaike	v aI k' E
vaikinas	v aI k' I n a s
vaikui	v aI k Ui
vaikus	v aI k U s
vaikystė	v aI k' i: s' t' e:
vaikščioja	v aI k S' tS' o: j a
vaikščiojo	v aI k S' tS' o: j o:
vaikų	v aI k u:
vairas	v aI r a s
vairuotojus	v aI r UO t o: j U s
vairuotojų	v aI r UO t o: j u:
vaisiais	v aI s' aI s
vaisius	v aI s' U s
vaisius	v aI s' U s
vaismedžiai	v aI s' m' E dZ' aI
vaizdai	v aI z d aI
vaizdingais	v aI z' d' I n g aI s
vaizdinius	v aI z' d' I n' U s
vaizdo	v aI z d o:
vaizduoklis	v aI z d UO k l' I s
vaizduotę	v aI z d UO t' {:
vakar	v A: k a r
vakare	v A: k a r' E
vakare	v a k a r' E
vakaro	v A: k a r o:
vakaruose	v a k a r UO s' E
valanda	v a 5 a n d a
valanda	v A: 5 a n d a
valandas	v A: 5 a n d a s
valandos	v A: 5 a n d o: s
valandos	v a 5 a n d o: s
valandą	v A: 5 a n d A:
valandų	v a 5 a n d u:
valdančiaisiais	v a 5 d a n' tS' aI s' aI s
valdove	v a 5 d o: v' E
valdove	v a 5 d o: v' E
valdė	v a l' d' e:
valdžia	v a l' dZ' a
valdžios	v a l' dZ' o: s
valdžios	v a l' dZ' o: s
valdžią	v a l' dZ' A:
valgio	v a l' g' o:
valgomajame	v a 5 g o: m a j a m' E
valgyti	v a l' g' i: t' I
valkata	v a l' k a t a
valstija	v a l' s' t' I j a
valstija	v a l' s' t' I j a
valstybė	v a l' s' t' i: b' e:
valstybės	v a l' s' t' i: b' e: s
vandeniu	v a n' d' E n' U
vandeniu	v a n' d' E n' U
vandeniu	v a n' d' {: n' U
vandens	v a n' d' E n s
vandenyno	v a n' d' E n' i: n o:
vandenyną	v a n' d' E n' i: n A:
vandenys	v a n' d' E n' i: s
vardas	v a r d a s
vardą	v a r d A:
varguoli	v a r g UO l' I
vargšų	v a r k S u:
varnos	v a r n o: s
vartojami	v a r t o: j a m' I
vartojimas	v a r t o: j I m a s
vartojimui	v a r t o: j I m Ui
varžančius	v a r Z a n' tS' U s
varžovus	v a r Z o: v U s
varžybos	v a r' Z' i: b o: s
varžybų	v a r' Z' i: b u:
varžytis	v a r' Z' i: t' I s
vasario	v a s A: r' o:
vasaros	v A: s a r o: s
vasarą	v A: s a r A:
veidas	v' EI d a s
veiksnys	v' EI k s' n' i: s
veikti	v' EI k t' I
veikti	v' EI k t' I
veltėdi	v' E l' t' e: d' I
verslininkams	v' E r' s' l' I n' I n k a m s
verslininkų	v' E r' s' l' I n' I n k u:
verslo	v' E r s 5 o:
verslą	v' E r' s 5 A:
vertinimo	v' E r' t' I n' I m o:
vertybe	v' E r' t' i: b' E
vežti	v' E S' t' I
vežti	v' E S' t' I
vidurio	v' I d U r' o:
viena	v' Ie n a
viena	v' Ie n a
vienas	v' Ie n a s
vienas	v' Ie n a s
vienetais	v' Ie n' E t aI s
vienintelis	v' Ie n' I n' t' E l' I s
vienodu	v' Ie n o: d U
vienodą	v' Ie n o: d A:
vienuolika	v' Ie n UO l' I k a
vienuolikta	v' Ie n UO l' I k t a
vienuoliktas	v' Ie n UO l' I k t a s
vienuolikto	v' Ie n UO l' I k t o:
vienuoliktą	v' Ie n UO l' I k t A:
vienuoliktų	v' Ie n UO l' I k t u:
vienuoliktųjų	v' Ie n UO l' I k t u: j u:
vieną	v' Ie n A:
vienų	v' Ie n u:
vieta	v' Ie t a
vietos	v' Ie t o: s
vietą	v' Ie t A:
viešbutyje	v' Ie Z b U t' i: j E
viešbučių	v' Ie Z b U tS' u:
viešėjo	v' Ie S' e: j o:
viešės	v' Ie S' e: s
vilioja	v' I l' o: j a
vilkinčių	v' I l' k' I n' tS' u:
virtuvėje	v' I r t U v' e: j E
viršininke	v' I r' S' I n' I n' k' E
viršuje	v' I r S U j E
vis	v' I s
visada	v' I s a d a
visai	v' I s aI
visame	v' I s a m' E
visapusiškai	v' I s a p U s' I S k aI
visiems	v' I s' Ie m s
visiškai	v' I s' I S k aI
viską	v' I s k A:
visuomenės	v' I s UO m' E n' e: s
visuomenės	v' I s UO m' E n' e: s
visuomenę	v' I s UO m' E n' {:
visuomet	v' I s UO m' E t
visus	v' I s U s
visą	v' I s A:
visų	v' I s u:
vizitinių	v' I z' I t' I n' u:
vištos	v' I S t o: s
vyks	v' i: k s
vyksta	v' i: k s t a
vynai	v' i: n aI
vynai	v' i: n aI
vyrai	v' i: r aI
vyras	v' i: r a s
vyresni	v' i: r' E s' n' I
vyresni	v' i: r' E s' n' I
vyriausybė	v' i: r' aU s' i: b' e:
vyriausybę	v' i: r' aU s' i: b' {:
vyriškumo	v' i: r' I S k U m o:
vyriškį	v' i: r' I S' k' i:
vėjas	v' e: j a s
vėjo	v' e: j o:
vėjuotas	v' e: j UO t a s
vėl	v' e: 5
vėliau	v' e: l' aU
vėžio	v' e: Z' o:
ypatinga	i: p a t' I n g a
ypatingai	i: p a t' I n g aI
ypač	i: p a tS
yra	i: r a
yra	i: r a
zonoje	z O n o: j E
Čapskis	tS A: p' s' k' I s
Čepas	tS' {: p a s
Černiaus	tS' E r' n' aU s
Česlovas	tS' E s 5 O v a s
Čili	tS' I l' I
Čiulada	tS' U 5 a d a
Čiurlionio	tS' U r' l' o: n' o:
čempionato	tS' E m' p' I j O n A: t o:
čia	tS' a
ėda	e: d a
ėmiau	e: m' aU
į	i:
įdomaus	i: d o: m aU s
įdomiomis	i: d o: m' o: m' I s
įdomios	i: d o: m' o: s
įdomios	i: d o: m' o: s
įeina	i: EI n a
įeiti	i: EI t' I
įgimtas	i: g' I m t a s
įgudę	i: g U d' {:
įgytas	i: g' i: t a s
įgyvendino	i: g' i: v' E n' d' I n o:
įkvėpė	i: k v' e: p' e:
įkyrūs	i: k' i: r u: s
įmonių	i: m o: n' u:
įmonė	i: m o: n' e:
įmonės	i: m o: n' e: s
įmonėse	i: m o: n' e: s' E
įrankiai	i: r a n' k' aI
įrankis	i: r a n' k' I s
įrašas	i: r a S a s
įrašytas	i: r a S' i: t a s
įrašų	i: r a S u:
įrengti	i: r' E n' k t' I
įrengti	i: r' E n' k t' I
įrengtos	i: r' E n k t o: s
įrengtos	i: r' E n k t o: s
įrodymų	i: r o: d' i: m u:
įrodyti	i: r o: d' i: t' I
įsiklausyti	i: s' I k 5 aU s' i: t' I
įsikūręs	i: s' I k u: r' {: s
įskilo	i: s' k' I 5 o:
įspėja	i: s' p' e: j a
įspūdis	i: s p u: d' I s
įtarimų	i: t a r' I m u:
įtikinama	i: t' I k' I n a m a
įvairaus	i: v aI r aU s
įvairiausių	i: v aI r' aU s' u:
įvairių	i: v aI r' u:
įvedimo	i: v' E d' I m o:
įvertinimų	i: v' E r' t' I n' I m u:
įvestų	i: v' E s t u:
įvestų	i: v' E s t u:
įvykio	i: v' i: k' o:
įvykį	i: v' i: k' i:
įžymiu	i: Z' i: m' U
Šakiai	S a k' aI
Šarlotė	S a r 5 O t' e:
Šiaulių	S' aU l' u:
Šiaurės	S' aU r' e: s
Šilainiai	S' I 5 aI n' aI
Širvaitis	S' I r v aI t' I s
Šiškienė	S' I S' k' Ie n' e:
Šiūkšta	S' u: k S t a
Šiūkšta	S' u: k S t a
Šokienė	S o: k' Ie n' e:
šakai	S A: k aI
šaknimis	S a k n' I m' I s
šakų	S a k u:
šalia	S a l' a
šalies	S a l' Ie s
šaligatvio	S a l' I g a t' v' o:
šalims	S a l' I m s
šalis	S a l' I s
šalių	S a l' u:
šalmas	S a 5 m a s
šaltiniai	S a l' t' I n' aI
šaltiniais	S a l' t' I n' aI s
šaltinių	S a l' t' I n' u:
šalyje	S a l' i: j E
šalys	S A: l' i: s
šalyse	S a l' i: s' E
šalyse	S a l' i: s' E
šedešimt	S' E d' {: S' I m t
šefe	S' E f' E
šeimininkė	S' EI m' I n' I n' k' e:
šeimos	S' EI m o: s
šeimos	S' EI m o: s
šešerius	S' {: S' E r' U s
šešerių	S' E S' E r' u:
šeši	S' E S' I
šešiasdešimt	S' {: S' a z' d' {: S' I m t
šešiasdešimt	S' {: S' a z' d' {: S' I m t
šešimt	S' {: S' I m t
šešiolika	S' E S' o: l' I k a
šešiolikta	S' E S' o: l' I k t a
šešioliktą	S' E S' o: l' I k t A:
šešios	S' {: S' o: s
šešių	S' E S' u:
šešta	S' E S t a
šeštadienio	S' E S t A: d' Ie n' o:
šeštadienį	S' E S t A: d' Ie n' i:
šešti	S' E S' t' I
šešto	S' {: S t o:
šeštoji	S' E S t o: j I
šeštų	S' E S t u:
šeštųjų	S' E S t u: j u:
ši	S' I
šiai	S' aI
šiais	S' aI s
šiandien	S' a n' d' Ie n
šiaurinės	S' aU r' I n' e: s
šiaurės	S' aU r' e: s
šie	S' Ie
šiemet	S' Ie m' E t
šieną	S' Ie n A:
šiltesnės	S' I l' t' E s' n' e: s
šiltesnės	S' I l' t' E s' n' e: s
šiluma	S' I 5 U m a
šiluma	S' I 5 U m a
šimtai	S' I m t aI
šimtas	S' I m t a s
šio	S' o:
šios	S' o: s
širdimi	S' I r' d' I m' I
šis	S' I s
šitie	S' I t' Ie
šiuolaikinės	S' UO 5 aI k' I n' e: s
šiureno	S' U r' {: n o:
šiurkštus	S' U r k S t U s
šią	S' A:
škvalai	S k v A: 5 aI
šlubuoja	S 5 U b UO j a
šokių	S o: k' u:
šonų	S o: n u:
šunų	S U n u:
švedai	S' v' E d aI
šveicarai	S' v' EI ts A: r aI
šventė	S' v' E n' t' e:
šventės	S' v' E n' t' e: s
šventųjų	S' v' E n t u: j u:
švenčia	S' v' E n' tS' a
šviesos	S' v' Ie s o: s
šviesos	S' v' Ie s o: s
šviesybe	S' v' Ie s' i: b' E
švietimo	S' v' Ie t' I m o:
šylant	S' i: 5 a n t
šį	S' i:
Ūkio	u: k' o:
ūglius	u: g l' U s
ūkį	u: k' i:
Žaliakalnis	Z a l' A: k a l' n' I s
Žemaitkiemis	Z' E m aI t' k' Ie m' I s
Žemės	Z' {: m' e: s
Žemę	Z' {: m' {:
Žiežmariai	Z' Ie Z m A: r' aI
Žilinskienė	Z' I l' I n' s' k' Ie n' e:
Žolinės	Z o: l' I n' e: s
Žolinės	Z o: l' I n' e: s
Žydrūnas	Z' i: d r u: n a s
Žygaičiai	Z' i: g aI tS' aI
žadami	Z a d a m' I
žadino	Z A: d' I n o:
žaibiškai	Z aI b' I S k aI
žaibus	Z aI b U s
žaidėjai	Z aI d' e: j aI
žaidėjams	Z aI d' e: j a m s
žaizdro	Z aI z d r o:
žaliausių	Z a l' aU s' u:
žalius	Z a l' U s
žaliąją	Z A: l' A: j A:
žalos	Z a 5 o: s
žalos	Z A: 5 o: s
žavi	Z a v' I
žavingoji	Z a v' I n g o: j I
žemėlapį	Z' E m' e: 5 a p' i:
žemės	Z' {: m' e: s
žemės	Z' E m' e: s
žemę	Z' {: m' {:
ženklą	Z' E n k 5 A:
žieve	Z' Ie v' E
žieve	Z' Ie v' E
žinias	Z' I n' a s
žiniasklaidą	Z' I n' A: s k 5 aI d A:
žinomas	Z' I n o: m a s
žiūrovams	Z' u: r o: v a m s
žiūrėti	Z' u: r' e: t' I
žmogau	Z m o: g aU
žmogaus	Z m o: g aU s
žmogus	Z m o: g U s
žmonių	Z m o: n' u:
žmonėms	Z m o: n' e: m s
žmonės	Z m o: n' e: s
žurnalistas	Z U r n a l' I s t a s
žuvininkystės	Z U v' I n' I n' k' i: s' t' e: s
žuvo	Z U v o:
žvalgybos	Z v a l' g' i: b o: s
žvejybos	Z' v' E j i: b o: s
žvyras	Z' v' i: r a s
žygiavo	Z' i: g' A: v o:
žymiai	Z' i: m' aI
žymiausi	Z' i: m' aU s' I
žymiausias	Z' i: m' aU s' a s
