<hes>	" G I m	" I m	" a	" A:_R
A	" A:_R	" a
Abraitis	a . " b r a_F I . t' I s
Adelė	a . " d' E . l' e:
Adolfas	" A:_R . d O 5 . f a s
Adomaitienė	a . d o: . " m a_F I . t' I e . n' e:
Adomavičius	a . d o: . " m A:_R . v' I . tS' U s
Afganistano	a f . g a . n' I . " s t A:_R . n o:
Agnė	" A:_R . g n' e:
Agrorodeo	a . g r O . r O . " d' E . O
Airinga	" a_F I . r' I n . g a
Aistė	" a_F I . s' t' e:
Akmenė	a k . " m' {:_R . n' e:
Akropolio	a . " k r O . p O . l' o:
Aleksonis	a . l' E k . " s o:_F . n' I s
Alna	a 5 . " n a	" a 5_R . n a
Alytus	a . l' i: . " t U s	a . " l' i:_R . t U s
Amerikoje	a . " m' E . r' I . k o: . j E
Amerikos	a . " m' E . r' I . k o: s
Andrejaitis	a n' . d' r' E . " j a_F I . t' I s
Andrius	" a n'_R . d' r' U s
Angela	" a_F n' . g' E . 5 a
Antrajam	a n . " t r A:_R . j a m
Anykščiai	a . n' i: k . " S' tS' a I_R	a . " n' i:_F k . S' tS' a I
Apanavičius	a . p a . " n A:_R . v' I . tS' U s
Aplinkos	a p' . l' I n . " k o:_R s
Apuolėje	a . " p U O_R . l' e: . j E
Arimeks	a . r' I . " m' E k s
Arnolda	" a_F r . n O 5 . d a
Artis	" a_F r' . t' I s
Artūras	a r . " t u:_F . r a s	a r . " t u:_R . r a s
Arvydas	" a r'_R . v' i: . d a s	a r' . " v' i:_F . d a s
Astos	" A:_R . s t o: s
Astra	a . " s t r a	" A:_R . s t r a
Atlanto	a t . " 5 a_F n . t o:
Audrius	" a U_R . d' r' U s	a U . " d' r' U s
Augustina	a U . g U . s' t' I . " n a	a U . g U . " s' t' I . n a
Aurika	" a_F U . r' I . k a	" a U_R . r' I . k a
Aurimas	" a U_R . r' I . m a s
Austė	" a_F U . s' t' e:
Azerbaidžanas	a . z' E r . b a I . " dZ A:_R . n a s
Azerbaidžaną	a . z' E r . b a I . " dZ A:_R . n A:
Bagaslaviškis	b a . g a . s 5 a . " v' I . S' k' I s	b a . g a . " s 5 A:_R . v' I . S' k' I s
Bagdonas	b a g . " d o:_R . n a s
Balio	" b A:_R . l' o:
Baltarusijoje	b a 5 . t a . " r U . s' I . j o: . j E
Baltijos	" b a_F l' . t' I . j o: s
Baniulis	b a . " n' U . l' I s
Bank	" b a_F n k
Barkauskas	b a r . " k a_F U . s k a s
Barselona	b a r' . s' E . 5 O . " n a	b a r' . s' E . " 5 O . n a
Barstyčiai	b a r' . " s' t' i:_F . tS' a I
Bazienė	b a . " z' I_F e . n' e:
Belfasto	" b' E_F 5 . f a . s t o:	b' E 5 . " f A:_R . s t o:
Belgrado	b' E 5 . " g r A:_R . d o:	" b' E 5_R . g r a . d o:
Belkevičienė	b' E l' . " k' {:_R . v' I . tS' I e . n' e:
Bendida	b' E n' . d' I . " d a
Bengalijoje	b' E n . " g A:_R . l' I . j o: . j E
Benjaminas	b' E n' . j a . " m' I . n a s
Betonika	b' E . " t O . n' I . k a
Birutė	b' I . " r U . t' e:
Blažytė	b 5 a . " Z' i:_F . t' e:
Bomelio	b O . " m' E . l' o:
Boreika	b o: . r' E I . " k a	b o: . " r' E I_R . k a
Britanijoje	b' r' I . " t A:_R . n' I . j o: . j E
Britaniją	b' r' I . " t A:_R . n' I . j A:
Bronius	" b r O . n' U s
Bugaitė	b U . " g a_F I . t' e:	b U . " g a I_R . t' e:
Butkevičius	b U t' . " k' {:_R . v' I . tS' U s	b U t' . k' {: . v' I . " tS' U s
Butrimonys	b U . t' r' I . " m o:_F . n' i: s
Bylienė	b' i: . " l' I_F e . n' e:
Dalia	d a . " l' a
Danguolė	d a n . " g U O_R . l' e:
Danske	" d a_F n' . s' k' E
Daugai	d a U . " g a I_R
Debrecenas	" d' E . b' r' E . ts' E . n a s
Didždvaris	" d' I dZ . d v a . r' I s
Didžiojoje	d' I . " dZ' o:_R . j o: . j E
Didžiąją	" d' I . dZ' A: . j A:
Digrys	d' I . " g r' i:_R s
Domicelė	d O . m' I . " ts' E . l' e:
Dominykas	d o: . m' I . " n' i:_R . k a s
Donatas	d O . " n A:_R . t a s
Druskininkai	" d r U s' . k' I . n' I n . k a I
Dzeta	" dz' E . t a
Dzeusas	" dz' E_F U . s a s
Dzūkijoje	dz u: . " k' I . j o: . j E
Dzūkijos	dz u: . " k' I . j o: s
Džakarta	dZ a . " k a_F r . t a
Džaulio	" dZ a_F U . l' o:
Džaulis	" dZ a_F U . l' I s
Džeimso	" dZ' E I m_R . s o:
Džomolungma	dZ O . m O . " 5 U_F n g . m a
Džomolungmos	dZ O . m O . " 5 U_F n g . m o: s
Džordžija	" dZ O_F r' . dZ' I . j a
Džordžijos	" dZ O_F r' . dZ' I . j o: s
Džordžtaunas	dZ O r tS . " t a_F U . n a s
Džordžtaune	dZ O r tS . " t a_F U . n' E
Džordžtauną	dZ O r tS . " t a_F U . n A:
Edgaras	" E d . g a . r a s
Edita	E . d' I . " t a	E . " d' I . t a
Edvinas	" E d' . v' I . n a s
Egidijus	E . " g' I . d' I . j U s
Egipto	E . " g' I p . t o:
Eimantas	" E I_R . m a n . t a s
Einoras	" E I_R . n o: . r a s
Ekscelencija	E k . s' ts' E . " l' E n'_R . ts' I . j a
Elektrokomplektas	E . l' E k . t r O . k O m' . " p' l' E k . t a s
Elena	E . l' E . " n a
Elparma	E 5 . p a r . " m a
Elžbieta	E l' . Z' b' I e . " t a	E l' . " Z' b' I e_R . t a
Endriejavas	E n' . d' r' I e . " j A:_R . v a s
Erikas	" E . r' I . k a s
Euroga	E U . r O . " g a
Europoje	E U . " r O . p o: . j E
Europos	E U . " r O . p o: s
Evaldas	" E . v a 5 . d a s
Everestu	E . v' E . r' E . " s t U	E . v' E . " r' E . s t U
Filipas	f' I . " l' I . p a s
Finansų	f' I . " n a_F n . s u:
Gajanos	g a . " j A:_R . n o: s
Garso	" g a r_R . s o:
Gediminas	g' E . d' I . " m' I . n a s
Gedimino	g' E . d' I . " m' I . n o:
Gedion	" g' E . d' I . j O n
Genovaitė	g' E . n O . " v a_F I . t' e:
Giedre	g' I e . " d' r' E	" g' I e_R . d' r' E
Giedrė	" g' I e_R d' . r' e:
Gintarė	" g' I_F n . t a . r' e:	" g' I n_R . t a . r' e:	g' I n . " t A:_R . r' e:
Goro	" g O . r O
Griškabūdis	" g r' I . S k a . b u: . d' I s
Gruziją	" g r U . z' I . j A:
Gudeliai	g U . " d' {:_R . l' a I
Guntienė	" g U n'_R . t' I e . n' e:
H_Permono	" G A:_R # " p' E r_R . m o: . n o:
Himalajų	G' I . m a . " 5 A:_R . j u:
Himalo	" G' I . m a . 5 O
Holdings	" G O_F l' . d' I n k s
Iduna	I . d U . " n a
Ieva	I e . " v a	" I e_R . v a
Ignalina	I g . n a . l' I . " n a	I g . n a . " l' I . n a
Indijos	" I_F n' . d' I . j o: s
Inga	" I_F n . g a
Irutė	I . " r U . t' e:
Islandija	I . " s 5 a_F n' . d' I . j a
Ispanijoje	I . " s p A:_R . n' I . j o: . j E
Italijoje	I . " t A:_R . l' I . j o: . j E
J	" j O t
Japonijos	j a . " p O . n' I . j o: s
Jieznas	" j I e_R . z n a s
Joana	j O . a . " n a	j O . " A:_R . n a
Jolanta	j o: . " 5 a_F n . t a
Jonas	" j o:_R . n a s
Jovita	j O . v' I . " t a	j O . " v' I . t a
Jucienė	j U . " ts' I_F e . n' e:
Julijona	j U . l' I . j o: . " n a	j U . l' I . " j o:_R . n a
Julijonas	j U . l' I . " j o:_R . n a s
Julius	" j U . l' U s
Juozapota	j U O . z a . p o: . " t a	j U O . z a . " p o:_R . t a
Juozas	" j U O_R . z a s
Jurbarkas	" j U_F r . b a r . k a s
Jurga	" j U_F r . g a
Jurgita	j U r' . g' I . " t a
Justinas	j U . " s' t' I . n a s
Justiniškės	j U . " s' t' I . n' I . S' k' e: s
Juškevičius	j U . " S' k' {:_R . v' I . tS' U s
Jūratė	j u: . " r A:_R . t' e:
Jūsų	" j u:_F . s u:
K_G	" k A:_R # " g' e:_R
Kaišiadorys	k a I . S' a . " d o:_F . r' i: s
Kanų	" k A:_R . n u:
Kapčiamiestis	" k A:_R p' . tS' a . m' I e . s' t' I s	k a p' . " tS' A:_R . m' I e . s' t' I s
Karolina	k a . r O . l' I . " n a	k a . r O . " l' I . n a
Karolis	" k A:_R . r O . l' I s
Karčiauskienė	k a r' . " tS' a_F U . s' k' I e . n' e:
Kaunas	" k a U_R . n a s
Kaune	k a U . " n' E	" k a U_R . n' E
Kauno	" k a U_R . n o:
Kautra	k a U . " t r a	" k a U_R . t r a
Kaveckas	k a . " v' {:_R ts . k a s
Kazimierinės	k a . z' I . m' I e . " r' I . n' e: s
Kazlų	k a . " z 5 u:_R
Kazys	k a . " z' i:_R s
Kazė	" k A:_R . z' e:	k a . " z' e:_R
Kernavė	k' E r . n a . " v' e:_R	k' E r . " n A:_R . v' e:
Kinijoje	" k' I . n' I . j o: . j E
Kinijos	" k' I . n' I . j o: s
Kirkorovas	k' I r . " k O . r O . v a s
Kirtimai	k' I r' . " t' I . m a I
Kleinauskas	k l' E I . " n a_F U . s k a s
Koliziejus	k O . l' I . " z' I e_R . j U s
Kolorado	k O . 5 O . " r A:_R . d o:
Konradas	" k O_F n . r a . d a s
Konstantino	k O n . s t a n' . " t' I . n o:
Konstituciją	k O n' . s' t' I . " t U . ts' I . j A:
Kopenhagos	k O . p' E n . " G A:_R . g o: s
Krepšta	k r' E p . " S t a
Kretoje	" k r' E . t o: . j E
Kristaus	" k r' I . s t a U s
Krokialaukis	" k r o:_F . k' a . 5 a U . k' I s
Krėvė	k r' e: . " v' e:_R
Kušlienė	k U . " S' l' I_F e . n' e:
Kęstas	" k' {:_R . s t a s
Kūčios	" k u:_R . tS' o: s	k u: . " tS' o:_R s
Labrenciškė	" 5 A:_R . b' r' E n' . ts' I . S' k' e:
Laima	" 5 a_F I . m a
Laimonas	" 5 a_F I . m o: . n a s
Laižuva	" 5 a I_R . Z U . v a
Laura	" 5 a_F U . r a
Lazdijai	5 a . " z' d' I . j a I
Lenkijoje	" l' E_F n' . k' I . j o: . j E
Leopoldas	l' E . O . " p O 5_R . d a s
Lietuva	l' I e . t U . " v a
Lietuvių	l' I e . " t U . v' u:
Lietuvoje	l' I e . t U . v o: . " j E
Lietuvos	l' I e . t U . " v o:_R s
Lietuvą	" l' I_F e . t U . v A:
Lina	l' I . " n a	" l' I . n a
Linas	" l' I . n a s	l' I . " n a s
Lingvobalt	l' I n g . v O . " b a_F 5 t
Linkuva	l' I n . k U . " v a	" l' I n_R . k U . v a
Lipniuvienės	" l' I p' . n' U . v' I e . n' e: s
Lisabona	l' I . s a . b O . " n a	l' I . s a . " b O . n a
Litnaglis	" l' I t . n a . g l' I s
Liucija	" l' U . ts' I . j a
Liudas	" l' U . d a s
Lotynų	5 o: . " t' i:_R . n u:
Lukas	" 5 U . k a s
Lukšių	5 U k . " S' u:_R
Luvro	" 5 U . v r o:
Lytagra	l' i: . t a . " g r a	l' i: . " t A:_R . g r a
Lėipkalnis	" l' e:_F . I p . k a l' . n' I s
Macijauskaitė	m a . ts' I . j a U . " s k a_F I . t' e:
Magdalena	m a g . d a . l' E . " n a	m a g . d a . " l' {:_R . n a
Mahanlangūro	m a . G a n . 5 a n . " g u:_R . r o:
Marijampolė	m a . r' I . " j a_F m . p o: . l' e:
Marius	" m A:_R . r' U s
Markel	" m a_F r' . k' E 5
Martynas	m a r' . " t' i:_R . n a s
Matuzienė	" m A:_R . t U . z' I e . n' e:
Medija	" m' E . d' I . j a
Mikalojaus	m' I . k a . " 5 o:_R . j a U s
Mindaugas	" m' I_F n . d a U . g a s
Mindaugo	" m' I_F n . d a U . g o:
Mingo	" m' I_F n . g o:
Mira	m' I . " r a	" m' I . r a
Modestas	m O . " d' E . s t a s
Monika	" m O . n' I . k a
Motiejus	m O . " t' I e_R . j U s
Motiejūnaitė	m o: . t' I e . " j u:_F . n a I . t' e:
Motinos	" m o:_F . t' I . n o: s
Muzikos	" m U . z' I . k o: s
Mykolas	" m' i:_F . k O . 5 a s
Nacionalinis	n a . ts' I . j O . " n A:_R . l' I . n' I s	n a . ts' O . " n A:_R . l' I . n' I s
Nafta	n a f . " t a	" n A:_R f . t a
Naujamiestis	n a U . " j A:_R . m' I e . s' t' I s
Naujieji	n a U . " j I_F e . j I
Nepalo	n' E . " p A:_R . 5 o:
Nerija	" n' {:_R . r' I . j a	n' E . r' I . " j a
Neringa	" n' E . r' I n . g a
Noliškio	n o: . " l' I . S' k' o:
Norfos	" n O_F r . f o: s
Odeta	o: . d' E . " t a
Orisoje	O . " r' I . s o: . j E
Otas	" o:_R . t a s
Ovidijus	O . " v' I . d' I . j U s
Pakalnienė	p a . " k a l'_R . n' I e . n' e:	p a . k a l' . " n' I_F e . n' e:
Pakaunėje	p a . k a U . n' e: . " j E
Panemunė	p a . n' E . " m U . n' e:
Panemunėlis	p a . n' E . m U . " n' e:_R . l' I s
Paryžiaus	p a . " r' i:_R . Z' a U s
Paulius	" p a U_R . l' U s	p a U . " l' U s
Paškevičiūtė	p a . S' k' E . v' I . " tS' u:_R . t' e:
Pernarava	" p' E_F r . n a . r a . v a
Perskaudienės	" p' E_F r . s k a U . d' I e . n' e: s
Petru	p' E . " t r U
Pijus	" p' I . j U s
Pikeliai	" p' I . k' E . l' a I
Pilviškiai	" p' I_F l' . v' I . S' k' a I
Plateliai	" p 5 A:_R . t' E . l' a I
Platonas	p 5 a . " t O . n a s
Pociūnėliai	p o: . ts' u: . " n' e:_R . l' a I
Pranas	" p r A:_R . n a s
Prancūziją	p r a n . ts u: . " z' I . j A:
Preskoto	" p' r' E . s k O . t O
Prezidentūra	p' r' E . z' I . d' E n . t u: . " r a	p' r' E . z' I . d' E n . " t u:_R . r a
Puckiene	p U ts' . " k' I_F e . n' E
Putokšnis	p U . " t o:_F k . S' n' I s
Ramunaitė	r a . m U . " n a_F I . t' e:
Rapolas	" r A:_R . p O . 5 a s
Rasa	r a . " s a
Rasmera	r a . s' m' E . " r a	r a . " s' m' E . r a
Raudonė	r a U . " d o:_R . n' e:
Regina	r' E . g' I . " n a	r' E . " g' I . n a
Remigijus	r' E . " m' I . g' I . j U s
Renata	r' E . n a . " t a
Rima	r' I . " m a	" r' I . m a
Rimantas	" r' I . m a n . t a s
Rimas	" r' I . m a s
Rimkai	r' I m . " k a I_R
Rimkus	" r' I_F m . k U s
Rita	r' I . " t a	" r' I . t a
Rivona	r' I . v O . " n a
Rokas	" r o:_R . k a s
Rokiškis	" r o:_R . k' I . S' k' I s
Rolandas	r o: . " 5 a_F n . d a s
Romas	" r O . m a s	" r o:_R . m a s
Romos	" r O . m o: s	" r o:_R . m o: s
Rudamina	r U . d a . m' I . " n a	r U . d a . " m' I . n a
Rudenėlio	r U . d' E . " n' e:_R . l' o:
Rusijai	" r U . s' I . j a I
Rusijos	" r U . s' I . j o: s
Rūda	r u: . " d a
Rūtė	" r u:_R . t' e:
S_B_ai	" E S # " b' e:_R # " a_F I
Samanta	s a . " m a_F n . t a
Samargathos	s a . m a r . " g A:_R t . G O s
Sandra	" s a_F n . d r a
Sasnava	s a . s n a . " v a	s a . " s n A:_R . v a
Saulius	" s a U_R . l' U s
Saulės	" s a_F U . l' e: s
Savickas	s a . " v' I ts . k a s
Seimo	" s' E I_R . m o:
Sidnėjus	s' I d' . " n' e:_R . j U s
Sigita	s' I . g' I . " t a	s' I . " g' I . t a
Sigitas	s' I . " g' I . t a s
Skirmantas	" s' k' I_F r . m a n . t a s
Skudutis	s k U . " d U . t' I s
Sokratas	s O . " k r A:_R . t a s
Sokrato	s O . " k r A:_R . t o:
Studija	" s t U . d' I . j a
Subačius	" s U . b a . tS' U s
Sąjungos	" s A:_F . j U n . g o: s
Tadas	" t A:_R . d a s
Tarvydytė	t a r' . v' i: . " d' i:_F . t' e:
Tauragė	t a U . r a . " g' e:_R
Tauragės	t a U . r a . " g' e:_R s
Telšiai	t' E l' . " S' a I_R
Teresė	t' E . " r' E . s' e:
Tokijuje	" t O . k' I . j U . j E
Tomas	" t O . m a s
Trakuose	" t r A:_R . k U O . s' E	t r a . k U O . " s' E
Trevena	t' r' E . v' E . " n a
Tyrilienė	" t' i:_F . r' I . l' I e . n' e:
Tėvo	" t' e:_F . v o:
Ukmergės	U k . m' E r' . " g' e:_R s
Ukrainos	U . k r a . " I . n o: s
Utena	U . t' E . " n a	" U . t' E . n a
Užkaukazės	" U S . k a U . k a . z' e: s
Vaclovas	" v A:_R . ts 5 O . v a s
Vaida	" v a_F I . d a
Vaiva	" v a_F I . v a
Vaišnorienė	" v a I_R . S n o: . r' I e . n' e:
Valančiūnas	v a . 5 a n' . " tS' u:_F . n a s
Valdas	" v a_F 5 . d a s	" v a 5_R . d a s
Valstijų	v a l' . " s' t' I . j u:
Varniai	" v a r'_R . n' a I	v a r' . " n' a I_R
Vaškai	v a . " S k a I_R
Velykos	v' E . " l' i:_F . k o: s
Ventus	v' E n . " t U s
Vertimų	v' E r' . " t' I . m u:
Vida	v' I . " d a	" v' I . d a
Vidas	" v' I . d a s
Viduržemio	v' I . " d U_F r' . Z' E . m' o:
Viešpatie	" v' I e_R . S p a . t' I e	v' I e . S p a . " t' I e_R
Vija	v' I . " j a	" v' I . j a
Vilkpėdė	" v' I l'_R k . p' e: . d' e:
Vilkyškiai	v' I l' . " k' i:_R . S' k' a I
Vilma	" v' I_F 5 . m a
Vilniaus	" v' I_F l' . n' a U s
Vilnius	" v' I_F l' . n' U s
Vilunta	v' I . 5 U n . " t a
Vincas	" v' I n_R . ts a s
Virginija	v' I r' . " g' I . n' I . j a
Visų	v' I . " s u:_R
Vitafarma	v' I . t a . f a r . " m a
Vitaras	" v' I . t a . r a s
Vitė	" v' I . t' e:
Voldemaras	v O l' . d' E . " m A:_R . r a s
Vorld	" v O_F r 5 d
Vytautas	" v' i:_F . t a U . t a s
Vėžauskienė	v' e: . " Z a_F U . s' k' I e . n' e:
Zapyškis	z a . " p' i:_F . S' k' I s
Zenonas	" z' E . n O . n a s
Zia	" z' I . j a
Zimblytė	z' I m' . " b' l' i:_F . t' e:
Zubovų	" z U . b O . v u:
a	" A:_R	" a
abėcėlės	a . b' e: . " ts' e:_R . l' e: s
aikštelės	a I k . " S' t' {:_R . l' e: s
akcentas	a k . " ts' E n_R . t a s	" A:_R k . ts' E n . t a s
akivaizdoj	a . " k' I . v a I . z d O j
akių	a . " k' u:_R
akmenį	" A:_R k . m' E . n' i:
akmuo	a k . " m U O_R
aktorius	" A:_R k . t o: . r' U s
aktorių	" A:_R k . t o: . r' u:
aktyvumas	a k . t' i: . " v U . m a s
akys	" A:_R . k' i: s
akį	" A:_R . k' i:
albumas	a 5 . " b U . m a s
alkoholio	a 5 . k O . " G O . l' o:
alternatyva	a l' . t' E r . n a . t' i: . " v a	a l' . t' E r . n a . " t' i:_R . v a
amerikietė	a . m' E . r' I . " k' I e_R . t' e:
amerikiečiai	a . m' E . r' I . " k' I e_R . tS' a I
anglai	" a_F n . g 5 a I
anglakalbėms	a n . g 5 a . " k a l'_R . b' e: m s
angliavandenių	a n' . g l' a . v a n' . " d' {:_R . n' u:
angliški	" a_F n' . g l' I . S' k' I
anglų	" a_F n . g 5 u:
anksčiau	a n' k . " S' tS' a U_R
ankštinių	" a_F n' k . S' t' I . n' u:
ansamblio	a n . " s a_F m' . b' l' o:
ant	" a n_R t
antra	a n . " t r a	" a n_R . t r a
antradienis	a n . " t r A:_R . d' I e . n' I s
antradienį	a n . " t r A:_R . d' I e . n' i:
antri	a n' . " t' r' I
antroji	a n . " t r o:_F . j I
antrą	" a n_R . t r A:
antrų	a n . " t r u:_R
antrųjų	a n . " t r u:_R . j u:
apdailai	" A:_R b . d a I . 5 a I
apie	a . " p' I e_R
apimtiems	a p' . I m' . " t' I_F e m s
apkartina	a p . " k a_F r' . t' I . n a
apsiginčiau	a p' . s' I . " g' I_F n' . tS' a U
apsižiūrėsime	a p' . s' I . Z' u: . " r' e:_F . s' I . m' E
apsčiai	a p' . " S' tS' a I_R
apvali	a p . v a . " l' I
apysakų	a . " p' i:_F . s a . k u:
apytiksliai	a . " p' i:_F . t' I k . s' l' a I
apžiūrėk	a b' . Z' u: . " r' e:_F k
apžvalgos	" A:_R b . Z v a 5 . g o: s	a b . Z v a 5 . " g o:_R s
ar	" a r_R
arba	a r . " b a
arbatą	a r . " b A:_R . t A:
architektai	a r' . x' I . " t' E k . t a I
architektūros	a r' . x' I . t' E k . " t u:_R . r o: s
arkliams	a r' . " k l' a_F m s
artimiausiu	a r' . t' I . " m' a_F U . s' U
artimiesiems	a r' . t' I . " m' I_F e . s' I e m s
artėjant	a r' . " t' e:_F . j a n t
asketizmu	a . s' k' E . t' I . " z m U	a . s' k' E . " t' I . z m U
asmeninis	a . s' m' E . " n' I . n' I s	a . " s' m' {:_R . n' I . n' I s
asmenybė	a . s' m' E . " n' i:_F . b' e:
asmenybę	a . s' m' E . " n' i:_F . b' {:
asmenų	a . s' m' E . " n u:_R
astronomai	a . s t r O . " n O . m a I
atakuojama	a . t a . " k U_F O . j a . m a
ateina	a . " t' E I_R . n a
ateityje	a . t' E I . t' i: . " j E
ateitį	" A:_R . t' E I . t' i:
atgavo	a d . " g A:_R . v o:
atgavę	a d . " g A:_R . v' {:
atidaroma	a . t' I . " d A:_R . r o: . m a
atidirbimo	a . t' I . d' I r' . " b' I . m o:
atitinkamai	a . t' I . " t' I n_R . k a . m a I
atjojantys	a t' . " j o:_F . j a n' . t' i: s
atkūrimo	a t . k u: . " r' I . m o:
atleidžiama	a t' . " l' E_F I . dZ' a . m a	a t' . l' E I . dZ' a . " m a
atleidžiami	a t' . l' E I . dZ' a . " m' I
atlieka	a t' . l' I e . " k a	" A:_R t' . l' I e . k a	a t' . " l' I e_R . k a
atlikta	" a t' . l' I k . t a	a t' . l' I k . " t a
atlikti	a t' . " l' I k . t' I	a t' . l' I k . " t' I
atlikėjas	a t' . l' I . " k' e:_F . j a s
atlikėjos	a t' . l' I . " k' e:_F . j o: s
atlyginimai	a . " t' l' i:_F . g' I . n' I . m a I
atmosfera	a t . m O . s' f' E . " r a	a t . m O . " s' f' E . r a
atneša	" a t' . n' E . S a
atomų	a . " t O . m u:
atostogų	a . " t o:_F . s t o: . g u:
atrado	a t . " r A:_R . d o:
atrasti	a t . " r a . s' t' I	a t . r a . " s' t' I
atrinktos	" a t' . r' I n k . t o: s	a t' . r' I n k . " t o:_R s
atrodė	a t . " r o:_F . d' e:
atsakomybės	a t . s a . k o: . " m' i:_F . b' e: s
atsakyti	a t . s a . " k' i:_F . t' I
atsargesni	a t . s a r' . g' E . " s' n' I
atsidūrė	a t' . s' I . " d u:_F . r' e:
atsigauti	a t' . s' I . " g a_F U . t' I	a t' . s' I . g a U . " t' I
atsiliepimą	a t' . s' I . l' I e . " p' I . m A:
atsirado	a t' . s' I . " r A:_R . d o:
atsiranda	a t' . s' I . " r a n_R . d a
atsiriboti	a t' . s' I . r' I . " b o:_F . t' I
atsisakė	a t' . s' I . " s A:_R . k' e:
atskleista	" a t' . s' k l' E I . s t a	a t' . s' k l' E I . " s t a
atspalviai	" A:_R t . s p a l' . v' a I
atspindintis	a t' . " s' p' I n'_R . d' I n' . t' I s
atspindys	a t' . s' p' I n' . " d' i:_R s
atvaizdu	" A:_R t . v a I . z d U
atvejų	" A:_R t' . v' E . j u:
atveria	" a t' . v' E . r' a
atvežęs	a t' . " v' {:_R . Z' {: s
atvyksta	a t' . " v' i:_R k . s t a
atvėsus	a t' . " v' e:_F . s U s
audringas	a U . " d' r' I_F n . g a s
auginant	a U . " g' I . n a n t
auklėjimą	" a_F U . k l' e: . j I . m A:
aukšta	a U k . " S t a	" a_F U k . S t a
aukštoji	a U k . " S t o:_F . j I
aukščiausias	a U k . " S' tS' a_F U . s' a s
autobuso	a U . t O . " b U . s o:
automobiliai	a U . t O . m O . " b' I . l' a I
automobilis	a U . t O . m O . " b' I . l' I s
automobiliu	a U . t O . m O . b' I . " l' U
automobilių	a U . t O . m O . " b' I . l' u:	a U . t O . " m O . b' I . l' u:
autoritetų	a U . t O . r' I . " t' E . t u:
avys	" A:_R . v' i: s
aš	" a S
aštunta	a . S t U n . " t a	a . " S t U n_R . t a
aštunti	a . S t U n' . " t' I
aštuntieji	a . S t U n' . " t' I_F e . j I
aštunto	a . " S t U_F n . t o:
aštuntą	a . " S t U n_R . t A:
aštuntų	a . S t U n . " t u:_R
aštuntųjų	a . S t U n . " t u:_R . j u:
aštuoni	a . S t U O . " n' I	a . " S t U_F O . n' I
aštuonias	a . " S t U_F O . n' a s
aštuoniasdešimt	a . " S t U_F O . n' a . z' d' {: . S' I m t	a . S t U O . n' a . " z' d' {:_R . S' I m t
aštuoniasdešimti	a . S t U O . n' a . z' d' E . S' I m' . " t' I
aštuoniolika	a . S t U O . " n' o:_F . l' I . k a
aštuoniolikos	a . S t U O . " n' o:_F . l' I . k o: s
aštuoniolikta	a . S t U O . " n' o:_F . l' I k . t a
aštuoniolikto	a . S t U O . " n' o:_F . l' I k . t o:
aštuonioliktoji	a . S t U O . " n' o:_F . l' I k . t o: . j I
aštuonioliktą	a . S t U O . " n' o:_F . l' I k . t A:
aštuonios	a . " S t U_F O . n' o: s
aštuonių	a . S t U O . " n' u:_R
baidarę	b a I . " d A:_R . r' {:
baigiamos	" b a I_R . g' a . m o: s	b a I . g' a . " m o:_R s
baigimo	b a I . " g' I . m o:
baigė	" b a I_R . g' e:
baigėsi	" b a I_R . g' e: . s' I
balandžio	b a . " 5 a n'_R . dZ' o:
baliaus	" b A:_R . l' a U s
balionai	b a . " l' O . n a I
balistines	b a . " l' I . s' t' I . n' E s
baltieji	b a l' . " t' I_F e . j I
bandantys	" b a n_R . d a n' . t' i: s
bandžiau	b a n' . " dZ' a_F U
banginių	b a n' . " g' I . n' u:
bankas	" b a_F n . k a s
bankroto	b a n . " k r O . t o:
bankrutavusių	b a n . k r U . " t A:_R . v U . s' u:
barzda	b a r . " z d a	" b a r_R . z d a
baudžia	" b a U_R . dZ' a
bazę	" b A:_R . z' {:
be	" b' E
bebrai	" b' {:_R . b r a I	" b' E . b r a I
bedarbiai	b' E . " d a r'_R . b' a I
bei	" b' E I_R
benamiai	b' E . " n A:_R . m' a I
bendraudami	b' E n . " d r a_F U . d a . m' I
bendraujame	b' E n . " d r a_F U . j a . m' E
bendravimas	b' E n . " d r A:_R . v' I . m a s
bendrovė	b' E n . " d r o:_F . v' e:
bendruomenę	b' E n . " d r U_F O . m' E . n' {:
bendrąją	" b' E n_R . d r A: . j A:
berneliui	b' E r' . " n' {:_R . l' U i
berniukas	b' E r' . " n' U . k a s
bet	" b' E t
beveik	b' E . " v' E_F I k
biokuro	b' I . j O . " k U . r o:
birželio	b' I r' . " Z' {:_R . l' o:
biržietė	b' I r' . " Z' I e_R . t' e:
biržoje	" b' I_F r . Z o: . j E
biudžeto	b' U . " dZ' E . t o:
biuras	" b' U . r a s
biški	" b' I . S' k' I
biškį	" b' I . S' k' i:
blizgių	" b' l' I . z' g' u:	b' l' I . " z' g' u:_R
blynus	b' l' i: . " n U s	" b' l' i:_R . n U s
bokšto	" b o:_F k . S t o:
bosnius	" b O . s' n' U s
botagu	b o: . t a . " g U
brahmanizmą	b r a G . m a . " n' I . z m A:
brandi	b r a n' . " d' I
brangioji	b r a n' . " g' o:_F . j I
brangsta	" b r a n_R k . s t a
britų	" b' r' I . t u:
broilerių	" b r O_F I . l' E . r' u:
brolau	b r o: . " 5 a U_R
bronzos	" b r O_F n . z o: s
bruožas	" b r U_F O . Z a s
budistų	b U . " d' I . s t u:
budizmo	b U . " d' I . z m o:
buriuotojams	b U . " r' U_F O . t o: . j a m s
burlaivis	" b U_F r . 5 a I . v' I s
burlenčių	" b U_F r' . l' E n' . tS' u:
bus	" b U s
buvo	" b U . v o:
bučiniu	" b U . tS' I . n' U
byloje	b' i: . 5 o: . " j E
bėga	b' e: . " g a	" b' e:_R . g a	" b' e:_F . g a
būdami	b u: . d a . " m' I
būdas	" b u:_R . d a s	b u: . " d a s
būdingos	b u: . " d' I_F n . g o: s
būdu	b u: . " d U
būstas	" b u:_F . s t a s
būstą	" b u:_F . s t A:
būti	" b u:_F . t' I	b u: . " t' I
būtybes	b u: . " t' i:_F . b' E s
būtų	" b u:_F . t u:	b u: . " t u:_R
centai	" ts' E n_R . t a I
centas	" ts' E n_R . t a s
centre	ts' E n' . " t' r' E	" ts' E n'_R . t' r' E
centrinės	ts' E n' . " t' r' I . n' e: s
centro	" ts' E n_R . t r o:
centru	ts' E n . " t r U
centų	" ts' E n_R . t u:
chemijos	" x' E . m' I . j o: s
cheminiai	" x' E . m' I . n' a I
cheminio	" x' E . m' I . n' o:
cheminis	" x' E . m' I . n' I s
cheminėmis	" x' E . m' I . n' e: . m' I s
chikas	" x' I . k a s
choro	" x O . r o:
chorą	" x O . r A:
cigaretes	ts' I . g a . r' E . " t' E s
citrinmedis	ts' I . " t' r' I n'_R . m' E . d' I s
civiliai	ts' I . " v' I . l' a I
cukraus	" ts U k . r a U s	" ts U . k r a U s
dabar	d a . " b a r_R
dadzibo	d a . " dz' I . b O
dailiai	" d a I_R . l' a I
dailės	d a I . " l' e:_R s	" d a I_R . l' e: s
daina	d a I . " n a	" d a I_R . n a
dainas	d a I . " n a s
dainininkas	d a I . n' I . " n' I n_R . k a s
dainininką	d a I . n' I . " n' I n_R . k A:
dainuoti	d a I . " n U_F O . t' I
daktare	" d A:_R k . t a . r' E
dalgiai	" d a l'_R . g' a I
dalgės	" d a l'_R . g' e: s
dalies	d a . " l' I e_R s
dalinkimės	d a . " l' I n'_R . k' I . m' e: s
dalis	d a . " l' I s
dalys	" d A:_R . l' i: s	d a . " l' i:_R s
dalyvavo	d a . l' i: . " v A:_R . v o:
dangoraižio	d a n . " g o:_F . r a I . Z' o:
danguje	d a n . g U . " j E
daosizmo	d a . O . " s' I . z m o:
dar	" d A:_R	" d a_F r	" d a r_R
darbams	d a r . " b a_F m s
darbas	" d a_F r . b a s
darbo	" d a_F r . b o:
darbuotojų	d a r . " b U_F O . t o: . j u:
darbus	" d a_F r . b U s	d a r . " b U s
darbą	" d a_F r . b A:
darbų	d a r . " b u:_R	" d a r_R . b u:
daro	" d A:_R . r o:
daryti	d a . " r' i:_F . t' I
daug	" d a U_R g
daugelis	" d a U_R . g' E . l' I s
daugeliu	" d a U_R . g' E . l' U
daugiau	d a U . " g' a U_R
daugiausia	d a U . " g' a_F U . s' a
dauguma	d a U . g U . " m a	" d a U_R . g U . m a
daugumoje	d a U . g U . m o: . " j E
daugybės	d a U . " g' i:_F . b' e: s
davė	" d A:_R . v' e:
dažnai	d a . " Z n a I_R
dažniau	d a . " Z' n' a U_R
dažniausiai	d a Z' . " n' a_F U . s' a I
dažų	d a . " Z u:_R
debatus	d' E . b a . " t U s	d' E . " b A:_R . t U s
deformavosi	d' E . f O r . " m A:_R . v o: . s' I
derliaus	" d' E r'_R . l' a U s
devinta	d' E . v' I n . " t a	d' E . " v' I n_R . t a
devinti	d' E . v' I n' . " t' I
devinto	d' E . " v' I n_R . t o:
devintoji	d' E . v' I n . " t o:_F . j I
devintų	d' E . v' I n . " t u:_R	d' E . " v' I n_R . t u:
devintųjų	d' E . v' I n . " t u:_R . j u:
devyni	d' E . v' i: . " n' I
devyniasdešimt	d' E . " v' i:_F . n' a z' . d' E . S' I m t	d' E . v' i: . n' a z' . " d' {:_R . S' I m t
devyniolika	d' E . v' i: . " n' o:_F . l' I . k a
devyniolikos	d' E . v' i: . " n' o:_F . l' I . k o: s
devyniolikta	d' E . v' i: . " n' o:_F . l' I k . t a
devynioliktoji	d' E . v' i: . " n' o:_F . l' I k . t o: . j I
devynios	d' E . " v' i:_F . n' o: s
devynių	d' E . v' i: . " n' u:_R
dešimt	" d' {:_R . S' I m t
dešimta	d' E . S' I m . " t a	d' E . " S' I m_R . t a
dešimtas	d' E . " S' I m_R . t a s	d' E . S' I m . " t a s
dešimto	d' E . " S' I m_R . t o:
dešimtą	d' E . " S' I m_R . t A:
didelio	" d' I . d' E . l' o:
didelius	" d' I . d' E . l' U s
didelės	" d' I . d' E . l' e: s
didelę	" d' I . d' E . l' {:
didenybe	d' I . d' E . " n' i:_F . b' E
didesne	d' I . d' E . " s' n' E
didesnius	d' I . d' E . " s' n' U s
didesnę	d' I . " d' E . s' n' {:
didieji	d' I . " d' I_F e . j I
didina	" d' I . d' I . n a
didvyriai	" d' I d' . v' i: . r' a I
didėja	d' I . " d' e:_F . j a
didįjį	" d' I . d' i: . j i:
didžiajame	d' I . " dZ' A:_R . j a . m' E
didžiausias	d' I . " dZ' a_F U . s' a s
didžiavosi	d' I . " dZ' A:_R . v o: . s' I
didžioji	d' I . " dZ' o:_F . j I
didžiulio	d' I . " dZ' U . l' o:
didžiulis	d' I . " dZ' U . l' I s
didžiulę	d' I . " dZ' U . l' {:
didžiulį	d' I . " dZ' U . l' i:
didžiuosiuose	d' I . " dZ' U O_R . s' U O . s' E
diena	d' I e . " n a	" d' I e_R . n a
dienomis	d' I e . n o: . " m' I s
dienoraštį	d' I e . " n o:_F . r a . S' t' i:
dienos	" d' I e_R . n o: s	d' I e . " n o:_R s
dieną	" d' I e_R . n A:
dienų	d' I e . " n u:_R
dinastijos	d' I . " n A:_R . s' t' I . j o: s
dirbančių	" d' I_F r . b a n' . tS' u:
dirbo	" d' I_F r . b o:
dirbti	" d' I_F r' p' . t' I
direktoriau	d' I . " r' E k . t O . r' a U
diskusijas	d' I . " s k U . s' I . j a s
diskusijos	d' I . " s k U . s' I . j o: s
dizainerė	d' I . " z a_F I . n' E . r' e:
drastiškai	" d r A:_R . s' t' I . S k a I
draudimu	d r a U . d' I . " m U
draudžiami	d r a U . dZ' a . " m' I
draugais	d r a U . " g a I_R s
draugams	d r a U . " g a_F m s
draugas	" d r a U_R . g a s
drauge	" d r a U_R . g' E	d r a U . " g' E
draugija	d r a U . g' I . " j a
draugiškame	" d r a U_R . g' I . S k a . m' E
draugiškumu	d r a U . g' I . S k U . " m U
drąsių	d r A: . " s' u:_R
du	" d U
dujų	" d U . j u:
duok	" d U_F O k
duomenimis	d U O . m' E . n' I . " m' I s
duomenų	d U O . m' E . " n u:_R
durims	" d U . r' I m s
dvaro	" d v A:_R . r o:
dvi	" d' v' I
dvidešimt	" d' v' I . d' E . S' I m t
dvidešimta	d' v' I . d' E . S' I m . " t a
dvidešimtą	d' v' I . d' E . " S' I m_R . t A:
dviejų	d' v' I e . " j u:_R
dviem	" d' v' I_F e m	" d' v' I e_R m
dviratininkai	" d' v' I . r a . t' I . n' I n . k a I
dviračiais	" d' v' I . r a . tS' a I s	d' v' I . " r A:_R . tS' a I s
dvišimt	" d' v' I . S' I m t
dvylika	" d' v' i:_F . l' I . k a
dvylikos	" d' v' i:_F . l' I . k o: s
dvylikto	" d' v' i:_F . l' I k . t o:
dvyliktokų	d' v' i: . l' I k . " t o:_R . k u:
dvyliktų	" d' v' i:_F . l' I k . t u:
dvyliktųjų	" d' v' i:_F . l' I k . t u: . j u:
dydžio	" d' i:_R . dZ' o:
dzenbudistines	dz' E n . b U . " d' I . s' t' I . n' E s
dzenbudizmas	dz' E n . b U . " d' I . z m a s
dzimbina	" dz' I m'_R . b' I . n a
dzingsi	" dz' I n'_R k . s' I
dziudo	dz' U . " d O
dzūkai	" dz u:_R . k a I
dzūkiškai	" dz u:_R . k' I . S k a I
dzūkiškais	" dz u:_R . k' I . S k a I s
dzūkišku	" dz u:_R . k' I . S k U
dzūkiškumu	dz u: . k' I . S k U . " m U
dėl	" d' e:_R 5
dėmesio	" d' e:_R . m' E . s' o:
dėstytojau	" d' e:_F . s' t' i: . t o: . j a U
dėžę	" d' e:_R . Z' {:
džabos	dZ a . " b o:_R s
džaglyja	" dZ A:_R . g l' i: . j a
džainizmas	dZ a I . " n' I . z m a s
džaivas	" dZ a_F I . v a s
džakadomis	dZ a . " k A:_R . d o: . m' I s
džalgą	" dZ a 5_R . g A:
džandža	" dZ a n_R . dZ a
džandžarą	dZ a n . " dZ A:_R . r A:
džarksėjo	dZ a r' k . " s' e:_F . j o:
džarkšt	" dZ a r_R k S t	" dZ a_F r k S t
džarškant	" dZ a r_R . S k a n t
džarškėjo	dZ a r' . " S' k' e:_F . j o:
džataka	" dZ A:_R . t a . k a
džatakos	" dZ A:_R . t a . k o: s
džatra	dZ a . " t r a
džauliais	" dZ a_F U . l' a I s
džaulių	" dZ a_F U . l' u:
džerimanderingas	dZ' E . r' I . m a n' . " d' E . r' I n . g a s
džiaugiuosi	dZ' a U . " g' U_F O . s' I
džiaugtis	" dZ' a U_R k . t' I s
džiaugėsi	" dZ' a U_R . g' e: . s' I
džinsuose	" dZ' I_F n . s U O . s' E
džokeris	" dZ O . k' E . r' I s
džonka	" dZ O_F n . k a
džonką	" dZ O_F n . k A:
džuzgūnas	dZ U . " z g u:_R . n a s
džuzgūno	dZ U . " z g u:_R . n o:
džvanga	" dZ v a_F n . g a
džvangtelėjo	" dZ v a_F n' k . t' E . l' e: . j o:
džvangės	dZ v a n' . " g' e:_R s
džvangėsi	dZ v a n' . " g' e:_F . s' I
džvengės	" dZ' v' E_F n' . g' e: s
džvikę	" dZ' v' I . k' {:
efektyvinti	E . f' E k . " t' i:_F . v' I n' . t' I
egzamino	E g . " z A:_R . m' I . n o:
egzaminą	E g . " z A:_R . m' I . n A:
egzaminų	E g . " z A:_R . m' I . n u:
egzemplioriais	E g . z' E m' . " p' l' o:_R . r' a I s
eiliuotai	E I . " l' U_F O . t a I
eiliuotais	E I . " l' U_F O . t a I s
eina	" E I_R . n a
ekipažas	E . k' I . " p A:_R . Z a s
ekonominės	E . k O . " n O . m' I . n' e: s
ekscelencija	E k . s' ts' E . " l' E n'_R . ts' I . j a
eksperimentų	E k . s' p' E . r' I . " m' E n_R . t u:
ekspozicijos	E k . s p O . " z' I . ts' I . j o: s
ekspozicijų	E k . s p O . " z' I . ts' I . j u:
ekstremalios	E k . s' t' r' E . m a . " l' o:_R s	E k . s' t' r' E . " m A:_R . l' o: s
elastanu	E . 5 a . s t a . " n U	E . 5 a . " s t A:_R . n U
elektros	E . " l' E k . t r o: s
elgesiui	" E l'_R . g' E . s' U i
emigraciją	E . m' I . " g r A:_R . ts' I . j A:
emocijas	E . " m O . ts' I . j a s
emocijų	E . " m O . ts' I . j u:
energetikos	E . n' E r' . " g' E . t' I . k o: s
energijos	E . " n' E_F r' . g' I . j o: s
entomologus	E n . t O . m O . 5 O . " g U s	E n . t O . m O . " 5 O . g U s
esantys	" {:_R . s a n' . t' i: s
estrados	E . " s t r A:_R . d o: s
euro	" E U_R . r o:
ežeras	" {:_R . Z' E . r a s
ežerų	E . Z' E . " r u:_R
fabrikas	" f A:_R . b' r' I . k a s
fabrikų	f a . b' r' I . " k u:_R
fanai	" f A:_R . n a I
fantazija	f a n . " t A:_R . z' I . j a
festivalis	f' E . s' t' I . " v A:_R . l' I s
festivalį	f' E . s' t' I . " v A:_R . l' i:
filmai	" f' I_F 5 . m a I
filmas	" f' I_F 5 . m a s
filmo	" f' I_F 5 . m o:
filmukas	f' I 5 . " m U . k a s
filosofas	f' I . 5 O . " s O . f a s
filosofijos	f' I . 5 O . " s O . f' I . j o: s
filosofiją	f' I . 5 O . " s O . f' I . j A:
filosofų	f' I . 5 O . " s O . f u:
finansavimo	f' I . n a n . " s A:_R . v' I . m o:
finansinė	f' I . " n a_F n' . s' I . n' e:
fizika	" f' I . z' I . k a
fizinis	" f' I . z' I . n' I s
foninė	" f O . n' I . n' e:
forma	" f O_F r . m a
formas	" f O_F r . m a s
formos	" f O_F r . m o: s
formuojant	f O r . " m U_F O . j a n t
formą	" f O_F r . m A:
forumo	" f O . r U . m o:
fotoaparatą	f O . t O . a . p a . " r A:_R . t A:
fotografams	f O . t O . " g r A:_R . f a m s
funkcijas	" f U_F n' k . ts' I . j a s
futbolas	" f U d . b O . 5 a s
gabenus	g a . " b' {:_R . n U s
gaisras	" g a I_R . s r a s
gaisro	" g a I_R . s r o:
gali	g a . " l' I	" g A:_R . l' I
galima	" g A:_R . l' I . m a
galimai	" g A:_R . l' I . m a I	g a . l' I . " m a I_R
galimas	" g A:_R . l' I . m a s	g a . l' I . " m a s
galimybių	g a . l' I . " m' i:_F . b' u:
galimybė	g a . l' I . " m' i:_F . b' e:
galimybę	g a . l' I . " m' i:_F . b' {:
galite	" g A:_R . l' I . t' E
galią	" g A:_R . l' A:
galu	g a . " 5 U
galvoti	g a 5 . " v o:_F . t' I
galą	" g A:_R . 5 A:
galėdama	g a . " l' e:_F . d a . m a
galėdavo	g a . " l' e:_F . d a . v o:
galės	g a . " l' e:_F s
gamyba	g a . " m' i:_F . b a
gamyboje	g a . " m' i:_F . b o: . j E
gamykla	g a . m' i: . " k 5 a	g a . " m' i:_R . k 5 a
gandai	g a n . " d a I_R
garbei	" g a r'_R . b' E I
garsas	" g a r_R . s a s
garsiai	" g a r'_R . s' a I
garsių	g a r' . " s' u:_R
garso	" g a r_R . s o:
garsus	g a r . " s U s
gatvelėse	g a t' . " v' {:_R . l' e: . s' E
gatviniais	" g A:_R t' . v' I . n' a I s	g a t' . " v' I . n' a I s
gatvėje	" g A:_R t' . v' e: . j E
gatvėmis	" g A:_R t' . v' e: . m' I s
gatvę	" g A:_R . t' v' {:
gausybė	g a U . " s' i:_F . b' e:
gauti	" g a_F U . t' I	g a U . " t' I
gegužės	g' E . g U . " Z' e:_R s	" g' {:_R . g U . Z' e: s
gelbėtojai	" g' E_F l' . b' e: . t o: . j a I
geležies	g' E . l' E . " Z' I e_R s
gerai	g' E . " r a I_R
geras	" g' {:_R . r a s	g' E . " r a s
gerasai	g' E . " r a . s a I
gerbiamasis	g' E r' . b' a . " m a . s' I s
geri	g' E . " r' I
geriausiai	g' E . " r' a_F U . s' a I
geriausiais	g' E . " r' a_F U . s' a I s
geriausias	g' E . " r' a_F U . s' a s
geriems	g' E . " r' I_F e m s
gero	" g' {:_R . r o:
gimnazijoje	g' I m . " n A:_R . z' I . j o: . j E
gimnaziją	g' I m . " n A:_R . z' I . j A:
gimtadienio	g' I m . " t A:_R . d' I e . n' o:
gimtinę	g' I m' . " t' I . n' {:
gimė	" g' I . m' e:
ginklo	" g' I n_R . k 5 o:
girdėti	g' I r' . " d' e:_F . t' I
girdžiu	g' I r' . " dZ' U
glumina	" g 5 U . m' I . n a
graikų	" g r a I_R . k u:
gramatikos	g r a . " m A:_R . t' I . k o: s
gramatinės	g r a . " m A:_R . t' I . n' e: s
grandines	g r a n' . d' I . " n' E s	g r a n' . " d' I . n' E s
greitesnėmis	g r' E I . t' E . s' n' e: . " m' I s
greitąją	" g r' E I_R . t A: . j A:
griausmą	" g r' a U_R . s m A:
griežtai	" g r' I_F e . S t a I	g r' I e . " S t a I_R
grindjuosčių	" g r' I n'_R d' . j U O . S' tS' u:
grindys	" g r' I n'_R . d' i: s
grindžiama	g r' I n' . dZ' a . " m a	" g r' I n'_R . dZ' a . m a
grindžiamas	" g r' I n'_R . dZ' a . m a s
gripo	" g r' I . p o:
grožio	" g r o:_R . Z' o:
gruodžio	" g r U_F O . dZ' o:
grupės	" g r U . p' e: s
gruzinų	g r U . " z' I . n u:
grybiena	g r' i: . " b' I_F e . n a
grybus	g r' i: . " b U s
grėsmingas	g r' e: . " s' m' I_F n . g a s
grėsmę	" g r' e:_R . s' m' {:
grįžo	" g r' i:_R . Z o:
grįžta	" g r' i:_R . S t a
gydytojau	" g' i:_F . d' i: . t o: . j a U
gynybos	g' i: . " n' i:_F . b o: s
gyvas	" g' i:_F . v a s	g' i: . " v a s
gyvena	g' i: . " v' {:_R . n a
gyvename	g' i: . " v' {:_R . n a . m' E
gyvenime	g' i: . " v' {:_R . n' I . m' E
gyvenimo	g' i: . " v' {:_R . n' I . m o:
gyventojų	g' i: . " v' E_F n . t o: . j u:
gyvulių	g' i: . v U . " l' u:_R
gyvybei	g' i: . " v' i:_F . b' E I
gyvūnai	g' i: . " v u:_R . n a I
gyvūnų	g' i: . " v u:_R . n u:
gėdingu	g' e: . " d' I_F n . g U
gėlių	g' e: . " l' u:_R
gėrėme	" g' e:_F . r' e: . m' E
harmoningai	G a r . m O . " n' I_F n . g a I
herojė	G' E . " r O . j e:
hospitalizuojamas	G O . s' p' I . t a . l' I . " z U_F O . j a . m a s
ideali	I . d' E . a . " l' I	I . d' E . " A:_R . l' I
idealios	I . d' E . " A:_R . l' o: s	I . d' E . a . " l' o:_R s
idėjomis	I . " d' e:_F . j o: . m' I s
ietį	" I_F e . t' i:
ieško	" j I_F e . S k o:
ieškoti	j I e . " S k o:_F . t' I
ikiteisminiai	I . k' I . t' E I . " s' m' I . n' a I
ilgai	I 5 . " g a I_R
ilgakočiais	I 5 . g a . " k o:_R . tS' a I s
ilgalaikę	I 5 . g a . " 5 a I_R . k' {:
ilgiausia	I l' . " g' a_F U . s' a
ilgų	I 5 . " g u:_R	" I 5_R . g u:
ima	" I . m a
imigraciją	I . m' I . " g r A:_R . ts' I . j A:
ims	" I m_R s
imtynės	I m' . " t' i:_R . n' e: s
indų	" I n_R . d u:
infarktas	I n . " f a_F r k . t a s
informacija	I n . f O r . " m A:_R . ts' I . j a
informacijos	I n . f O r . " m A:_R . ts' I . j o: s
informavimo	I n . f O r . " m A:_R . v' I . m o:
informuojantį	I n . f O r . " m U_F O . j a n' . t' i:
iniciatyva	I . n' I . ts' I . j a . t' i: . " v a
iniciatyvų	I . n' I . ts' I . j a . t' i: . " v u:_R
inkarą	" I n_R . k a . r A:
inspektoriumi	I n' . " s' p' E k . t O . r' U . m' I
intarpais	" I n_R . t a r . p a I s
intelektas	I n' . t' E . " l' E k . t a s
interjero	I n' . t' E r' . " j E . r o:
internetas	I n' . t' E r' . " n' E . t a s
internete	I n' . t' E r' . n' E . " t' E	I n' . t' E r' . " n' E . t' E
internetinės	I n' . t' E r' . " n' E . t' I . n' e: s
investavę	I n' . v' E . " s t A:_R . v' {:
investuotojų	I n' . v' E . " s t U_F O . t o: . j u:
ir	" I r_R
irkluoti	I r . " k 5 U_F O . t' I
ispanai	I . " s p A:_R . n a I
istorijos	I . " s t O . r' I . j o: s
istorinę	I . " s t O . r' I . n' {:
italai	I . " t A:_R . 5 a I
itin	" I . t' I n
iš	" I S
išauga	I S . " a_F U . g a
išbertas	I Z' . " b' E_F r . t a s
išbūti	I . " Z b u:_F . t' I
išdėstyta	I Z' . " d' e:_F . s' t' i: . t a
išeities	I S' . " E I_R . t' I e s
išgirdau	I Z' . g' I r . " d a U_R
išgirsti	I Z' . g' I r' s' . " t' I	I Z' . " g' I r'_R s' . t' I
iškasenos	" I S . k a . s' E . n o: s
iškvietė	" I S' . k v' I e . t' e:
išlaiko	I S . " 5 a I_R . k o:
išlaikoma	I S . " 5 a I_R . k o: . m a
išlaikytos	I S . 5 a I . " k' i:_F . t o: s
išleidžiama	I S' . " l' E_F I . dZ' a . m a
išlieka	I S' . " l' I e_R . k a
išlikti	I S' . " l' I k . t' I
išlipusi	I S' . " l' I . p U . s' I
išmėtė	" I S' . m' e: . t' e:
išraiškingas	I S . r a I . " S' k' I_F n . g a s
išreiškiamas	I S' . " r' E_F I . S' k' a . m a s
išsakė	I . " s A:_R . k' e:	I S . " s A:_R . k' e:
išsaugojo	I . " s a_F U . g o: . j o:	I S . " s a_F U . g o: . j o:
išsekę	I . " s' {:_R . k' {:	I S' . " s' {:_R . k' {:
išsidėstęs	I S' . s' I . " d' e:_F . s' t' {: s	I . s' I . " d' e:_F . s' t' {: s
išsikėlę	I S' . s' I . " k' e:_F . l' {:	I . s' I . " k' e:_F . l' {:
išsilaisvinusi	I S' . s' I . " 5 a_F I s' . v' I . n U . s' I	I . s' I . " 5 a_F I s' . v' I . n U . s' I
išsirinkti	I . s' I . " r' I n'_R k . t' I	I . s' I . r' I n' k . " t' I	I S' . s' I . " r' I n'_R k . t' I	I S' . s' I . r' I n' k . " t' I
išsiskiria	I S' . " s' I . s' k' I . r' a	I . " s' I . s' k' I . r' a
išsiuntė	" I . s' U n' . t' e:	" I S' . s' U n' . t' e:
išsivystymo	I . s' I . " v' i:_F . s' t' i: . m o:	I S' . s' I . " v' i:_F . s' t' i: . m o:
išsivysčiusių	I . s' I . " v' i:_F . S' tS' U . s' u:	I S' . s' I . " v' i:_F . S' tS' U . s' u:
ištikimybė	I S' . t' I . k' I . " m' i:_F . b' e:
išvažiuoti	I S . v a . " Z' U_F O . t' I
išvyko	I S' . " v' i:_R . k o:
jau	" j a U_R
jaukus	j a U . " k U s	" j a U_R . k U s
jauniesiems	j a U . " n' I_F e . s' I e m s
jaunimo	j a U . " n' I . m o:
jaunuoli	j a U . " n U O_R . l' I
jaunuolis	j a U . " n U O_R . l' I s
jausis	" j a U_R . s' I s
jausmus	j a U . " s m U s
jaustis	" j a U_R . s' t' I s
jaučiasi	" j a U_R . tS' a . s' I
jei	" j E_F I
jeigu	" j E_F I . g U
ji	" j I
jie	" j I e_R
jis	" j I s
jo	" j o:_R
jogurto	j O . " g U_F r . t o:	" j O . g U r . t o:
jojant	" j o:_F . j a n t
jokias	" j o:_F . k' a s
jokių	j o: . " k' u:_R
judriausia	j U . " d' r' a_F U . s' a
juodojo	" j U_F O . d o: . j o:
juridinę	j U . " r' I . d' I . n' {:
ją	" j A:_R
jėgas	j e: . " g a s
jėgos	" j e:_R . g o: s	j e: . " g o:_R s
jūra	" j u:_F . r a
jūroje	" j u:_F . r o: . j E
jūros	" j u:_F . r o: s
jūrų	" j u:_F . r u:
jūs	" j u:_R s
jūsų	" j u:_F . s u:
kablelis	k a . " b' l' {:_R . l' I s
kablys	k a . " b' l' i:_R s
kad	" k a d
kai	" k a I_R
kaimais	" k a_F I . m a I s
kaimas	" k a_F I . m a s
kaimyninėse	k a I . " m' i:_F . n' I . n' e: . s' E
kaimynė	k a I . " m' i:_F . n' e:
kaimynų	k a I . " m' i:_F . n u:
kaimų	" k a_F I . m u:	k a I . " m u:_R
kainą	" k a_F I . n A:
kaip	" k a I_R p
kalakutiena	k a . 5 a . k U . " t' I_F e . n a
kalavijai	k a . 5 a . " v' I . j a I
kalavijas	k a . 5 a . " v' I . j a s
kalba	" k a 5_R . b a	k a 5 . " b a
kalbai	" k a 5_R . b a I
kalbos	k a 5 . " b o:_R s	" k a 5_R . b o: s
kalbėti	k a l' . " b' e:_F . t' I
kalbų	k a 5 . " b u:_R	" k a 5_R . b u:
kalnagūbriui	k a 5 . " n A:_R . g u: . b' r' U i
kalnas	" k a_F 5 . n a s
kalnyno	k a l' . " n' i:_F . n o:
kalnų	k a 5 . " n u:_R
kalvės	" k a_F l' . v' e: s
kambariams	k a m . b a . " r' a_F m s
kambariuose	k a m . b a . r' U O . " s' E	k a m . b a . " r' U_F O . s' E
kambaryje	k a m . b a . r' i: . " j E
kamera	" k A:_R . m' E . r a
kanalų	k a . " n A:_R . 5 u:
kankino	k a n' . " k' I . n o:
kanoną	k a . " n O . n A:
karaliau	k a . " r A:_R . l' a U
karaliumi	k a . " r A:_R . l' U . m' I
kardai	" k a_F r . d a I	k a r . " d a I_R
kardeliais	k a r' . " d' {:_R . l' a I s
kardą	" k a_F r . d A:	" k a r_R . d A:
kareiviams	k a . " r' E I_R . v' a m s
kareivis	k a . " r' E I_R . v' I s
kariai	k a . " r' a I_R
karjerą	k a r' . " j E . r A:
kartojame	k a r . " t o:_F . j a . m' E
kartu	k a r . " t U
kartą	" k a_F r . t A:	" k a r_R . t A:
karui	" k A:_R . r U i
karą	" k A:_R . r A:
karštai	" k a_F r . S t a I	k a r . " S t a I_R
karūnavimo	k a . r u: . " n A:_R . v' I . m o:
kas	" k a s
kasdien	k a z' . " d' I e_R n
kasdienybė	k a . z' d' I e . " n' i:_F . b' e:
kaspino	" k A:_R . s' p' I . n o:
katedra	" k A:_R . t' E . d r a
katė	k a . " t' e:_R
kausis	" k a_F U . s' I s	" k a U_R . s' I s
kažkas	k a . " S k a s
kažkur	k a S . " k U r_R
kažką	k a S . " k A:_R
kdario	" g d A:_R . r' o:
keistų	" k' E I_R . s t u:	k' E I . " s t u:_R
keleivių	k' E . " l' E I_R . v' u:
keletas	" k' {:_R . l' E . t a s
kelia	" k' {:_R . l' a
keliais	k' E . " l' a I_R s	" k' {:_R . l' a I s
kelias	" k' {:_R . l' a s	k' E . " l' a s
keliasi	" k' {:_R . l' a . s' I
keliautojai	k' E . " l' a_F U . t o: . j a I
keliavimas	k' E . " l' A:_R . v' I . m a s
kelininkai	" k' {:_R . l' I . n' I n . k a I
kelio	" k' {:_R . l' o:
kelionei	k' E . " l' o:_R . n' E I
kelionių	k' E . " l' o:_R . n' u:
kelionėmis	k' E . " l' o:_R . n' e: . m' I s
kelionėse	k' E . " l' o:_R . n' e: . s' E
keliu	k' E . " l' U
kelius	k' E . " l' U s
kelių	k' E . " l' u:_R	" k' {:_R . l' u:
kepu	k' E . " p U
keturi	k' E . t U . " r' I
keturiasdešimt	" k' {:_R . t U . r' a z' . d' E . S' I m t	k' {: . t U . r' a z' . " d' {:_R . S' I m t	" k' {:_R . t U . r' a z' . d' {: . S' I m t
keturiasdešimtų	k' E . t U . r' a . z' d' E . S' I m . " t u:_R
keturiolika	k' E . t U . " r' o:_F . l' I . k a
keturiolikos	k' E . t U . " r' o:_F . l' I . k o: s
keturiolikta	k' E . t U . " r' o:_F . l' I k . t a
keturioliktą	k' E . t U . " r' o:_F . l' I k . t A:
keturios	" k' {:_R . t U . r' o: s
keturių	k' E . t U . " r' u:_R
ketverius	" k' {:_R t' . v' E . r' U s
ketvirta	k' E . t' v' I r . " t a	k' E . " t' v' I r_R . t a
ketvirtadienis	k' E . t' v' I r . " t A:_R . d' I e . n' I s
ketvirtas	k' E . " t' v' I r_R . t a s	k' E . t' v' I r . " t a s
ketvirti	k' E t' . v' I r' . " t' I
ketvirto	k' E t' . " v' I r_R . t o:
ketvirtoji	k' E t' . v' I r . " t o:_F . j I
ketvirtą	k' E . " t' v' I r_R . t A:
ketvirtų	k' E . t' v' I r . " t u:_R
ketvirtųjų	k' E t' . v' I r . " t u:_R . j u:
kiaulių	" k' a U_R . l' u:
kiek	" k' I_F e k
kiekis	" k' I e_R . k' I s
kiekviena	k' I e k . v' I e . " n a	k' I e k . " v' I_F e . n a
kiekvienas	k' I e . " k v' I_F e . n a s
kiekvieną	k' I e k . " v' I_F e . n A:
kieme	k' I e . " m' E	" k' I e_R . m' E
kiemą	" k' I e_R . m A:
kilometrinę	k' I . 5 O . m' E . " t' r' I . n' {:
kimono	k' I . m O . " n O
kino	" k' I . n o:
kinų	" k' I . n u:
kita	k' I . " t a	" k' I . t a
kitais	k' I . " t a I_R s
kitokiam	k' I . " t o:_F . k' a m
kitokių	k' I . " t o:_F . k' u:
kitos	k' I . " t o:_R s	" k' I . t o: s
kitą	" k' I . t A:
kitų	k' I . " t u:_R
kišenėse	k' I . " S' {:_R . n' e: . s' E
klaidinančią	k 5 a I . " d' I . n a n' . tS' A:
klaidą	" k 5 a I_R . d A:
klaidžiai	" k 5 a I_R . dZ' a I
klastojimu	k 5 a . " s t o:_F . j I . m U
klasėje	" k 5 A:_R . s' e: . j E
klausosi	" k 5 a U_R . s o: . s' I
klientai	k l' I . " j E n_R . t a I
klijuojami	k l' I . " j U_F O . j a . m' I
klipe	k l' I . " p' E
kloti	" k 5 o:_F . t' I	k 5 o: . " t' I
knyga	" k n' i:_R . g a	k n' i: . " g a
knygos	" k n' i:_R . g o: s
knygynuose	k n' i: . " g' i:_F . n U O . s' E
knygą	" k n' i:_R . g A:
knygų	" k n' i:_R . g u:
kodas	" k O . d a s
kojas	" k o:_F . j a s
kokie	k o: . " k' I e_R
koks	" k o:_F k s
kokybė	k o: . " k' i:_F . b' e:
kokį	" k o:_R . k' i:	" k o:_F . k' i:
kol	" k O 5_R
kolega	k O . l' E . " g a	k O . " l' E . g a
komanda	k O . " m a_F n . d a
komandų	k O . " m a_F n . d u:
komisiją	k O . " m' I . s' I . j A:
kompanija	k O m . " p A:_R . n' I . j a
kompiuterių	k O m' . " p' U . t' E . r' u:
komplimentų	k O m' . p' l' I . " m' E n_R . t u:
koncernas	k O n' . " ts' E_F r . n a s
koncertai	k O n' . " ts' E_F r . t a I
koncerto	k O n' . " ts' E_F r . t o:
konflikto	k O n' . " f' l' I k . t o:
konkurencijos	k O n . k U . " r' E n'_R . ts' I . j o: s
konkurso	k O n . " k U_F r . s o:
konkursų	k O n . " k U_F r . s u:	" k O_F n . k U r . s u:
konsulato	k O n . s U . " 5 A:_R . t o:
konsultantei	k O n . s U 5 . " t a_F n' . t' E I
kontrabandines	k O n . t r a . " b a_F n' . d' I . n' E s
korta	k O r . " t a	" k O r_R . t a
kortelių	k O r' . " t' {:_R . l' u:
kosmoso	" k O . s m O . s o:
kovo	" k o:_F . v o:
kraštovaizdžiu	k r a . " S t o:_F . v a I Z' . dZ' U
kraštu	k r a . " S t U
kregždės	" k r' {:_R g . Z' d' e: s	k r' E g . " Z' d' e:_R s
kreipsis	" k r' E I_R p' . s' I s
kreipė	" k r' E I_R . p' e:
krentančios	" k r' E n_R . t a n' . tS' o: s
krepšininkų	" k r' {:_R p' . S' I . n' I n . k u:
krepšinio	k r' E p' . " S' I . n' o:
krikščionys	k r' I k . " S' tS' o:_F . n' i: s
kriminalinis	k r' I . m' I . " n A:_R . l' I . n' I s
kriminalinės	k r' I . m' I . " n A:_R . l' I . n' e: s
krizės	" k r' I . z' e: s
krizę	" k r' I . z' {:
krokodilai	k r O . k O . " d' I . 5 a I
kruizinio	k r U . " I . z' I . n' o:
kryptis	k r' i: p' . " t' I s
krūmą	" k r u:_F . m A:
krūmų	" k r u:_F . m u:
krūties	k r u: . " t' I e_R s
krūvą	" k r u:_R . v A:
kultūra	k U 5 . t u: . " r a	k U 5 . " t u:_R . r a
kultūriniai	k U 5 . " t u:_R . r' I . n' a I
kultūrų	k U 5 . " t u:_R . r u:
kunigaikščio	k U . n' I . " g a_F I k . S' tS' o:
kunigas	" k U . n' I . g a s
kuo	" k U O_R
kupranugariai	k U . p r a . n U . " g A:_R . r' a I
kur	" k U r_R
kuri	k U . " r' I
kuriam	k U . " r' a_F m	" k U . r' a m
kuriame	k U . r' a . " m' E
kurioje	k U . r' o: . " j E
kuris	k U . " r' I s
kurią	k U . " r' A:_R
kuro	" k U . r o:
kurį	k U . " r' i:_R
kvailystes	k v a I . l' i: . " s' t' E s	k v a I . " l' i:_R . s' t' E s
kvalifikuotos	k v a . l' I . f' I . " k U_F O . t o: s
kviesdavo	" k v' I e_R . z d a . v o:
kviečiami	k v' I e . tS' a . " m' I
kylantis	" k' i:_R . 5 a n' . t' I s
ką	" k A:_R
kąsnio	" k A:_F . s' n' o:
kūriniai	k u: . r' I . " n' a I_R
kūrėjai	k u: . " r' e:_F . j a I
labai	5 a . " b a I_R
labiausiai	5 a . " b' a_F U . s' a I
laboratorija	5 a . b O . r a . " t O . r' I . j a
laidos	5 a I . " d o:_R s	" 5 a I_R . d o: s	" 5 a_F I . d o: s
laikoma	" 5 a I_R . k o: . m a
laikomas	" 5 a I_R . k o: . m a s
laikomi	" 5 a I_R . k o: . m' I
laikyti	5 a I . " k' i:_F . t' I
laiką	" 5 a I_R . k A:
laikų	5 a I . " k u:_R
laimi	5 a I . " m' I	" 5 a I_R . m' I
laimingesnė	5 a I . m' I n' . " g' E . s' n' e:
laimingesnę	5 a I . m' I n' . " g' E . s' n' {:
laimėjo	5 a I . " m' e:_F . j o:
laimėjusi	5 a I . " m' e:_F . j U . s' I
laiptų	" 5 a_F I p . t u:
laisvalaikiu	5 a I . " s v A:_R . 5 a I . k' U
laisve	" 5 a_F I . s' v' E
laivo	" 5 a I_R . v o:
laiškuose	5 a I . S k U O . " s' E
lakią	" 5 A:_R . k' A:
lango	" 5 a_F n . g o:
lapai	" 5 A:_R . p a I
lapeliai	5 a . " p' {:_R . l' a I
lapkričio	" 5 A:_R p' . k r' I . tS' o:
lapus	5 a . " p U s
lauke	5 a U . " k' E	" 5 a U_R . k' E
laukia	" 5 a_F U . k' a
lauko	" 5 a U_R . k o:
laukti	" 5 a_F U k . t' I
laužo	" 5 a_F U . Z o:
lazda	5 a . " z d a
ledai	l' E . " d a I_R
ledams	l' E . " d a_F m s
ledų	l' E . " d u:_R
legendų	l' E . " g' E n_R . d u:
leidžia	" l' E_F I . dZ' a
leitenante	l' E I . t' E . " n a_F n' . t' E
lemia	" l' {:_R . m' a
lemiantis	" l' {:_R . m' a n' . t' I s
lengviau	l' E n' g . " v' a U_R
lentynos	l' E n' . " t' i:_F . n o: s
liberali	l' I . b' E . r a . " l' I
liepos	" l' I_F e . p o: s
liepsnoje	l' I e p . s n o: . " j E
lietuvaičiai	l' E . t U . " v a_F I . tS' a I
lietuviai	l' I e . " t U . v' a I
lietuvių	l' I e . " t U . v' u:
liftus	l' I f . " t U s	" l' I f . t U s
link	" l' I n_R k
linksma	" l' I n_R k . s m a	l' I n k . " s m a
linkę	" l' I n'_R . k' {:
litai	" l' I . t a I
litas	" l' I . t a s
literatūra	l' I . t' E . r a . t u: . " r a	l' I . t' E . r a . " t u:_R . r a
literatūros	l' I . t' E . r a . " t u:_R . r o: s
lito	" l' I . t o:
litų	" l' I . t u:
liudijimo	" l' U . d' I . j I . m o:
liūdnas	" l' u:_R d . n a s
lovą	" 5 o:_F . v A:
lyderiai	" l' i:_F . d' E . r' a I
lyderio	" l' i:_F . d' E . r' o:
lyderė	" l' i:_F . d' E . r' e:
lyg	" l' i:_F k	" l' i:_R k
lygiai	" l' i:_F . g' a I
lygis	" l' i:_R . g' I s
lygumų	l' i: . g U . " m u:_R	l' i: . " g U . m u:
lyja	" l' i:_R . j a
lėktuvais	l' e: k . " t U . v a I s
lėkštas	" l' e:_R k . S t a s	l' e: k . " S t a s
lėkštė	l' e: k . " S' t' e:_R
lėkštę	" l' e:_R k . S' t' {:
lėmė	" l' e:_F . m' e:
lūkesčius	" 5 u:_R . k' E . S' tS' U s
lūžta	" 5 u:_F . S t a
m-hm	m . " G m
mada	m a . " d a	" m A:_R . d a
mados	m a . " d o:_R s	" m A:_R . d o: s
magistre	m a . g' I . " s' t' r' E	m a . " g' I . s' t' r' E
mahajanistinio	m a . G a . j a . " n' I . s' t' I . n' o:
maistine	m a I . " s' t' I . n' E	m a I . s' t' I . " n' E
maisto	" m a I_R . s t o:
makiažas	m a . k' I . " j A:_R . Z a s
maloni	m a . 5 o: . " n' I
malonu	m a . 5 o: . " n U
malonumas	m a . 5 o: . " n U . m a s
malonumus	m a . 5 o: . n U . " m U s
malonumą	m a . 5 o: . " n U . m A:
man	" m a_F n
manbase	m a n . b a . " s' E
mano	" m a . n o:	" m A:_R . n o:
manoma	" m A:_R . n o: . m a
manęs	m a . " n' {:_R s	" m A:_R . n' {: s
marmuras	" m a_F r . m U . r a s
maro	" m A:_R . r o:
masės	" m A:_R . s' e: s
matematikos	m a . t' E . " m A:_R . t' I . k o: s
matuojami	m a . " t U_F O . j a . m' I
matyti	m a . " t' i:_F . t' I
mače	" m A:_R . tS' E	m a . " tS' E
mašinų	m a . " S' I . n u:	" m A:_R . S' I . n u:
mažai	m a . " Z a I_R	" m A:_R . Z a I
mažas	" m A:_R . Z a s
maždaug	m a . " Z d a U_R k
mažiau	m a . " Z' a U_R	" m a . Z' a U
mažiausiai	m a . " Z' a_F U . s' a I
mažmena	m a . Z' m' E . " n a	" m A:_R . Z' m' E . n a
mažą	" m A:_R . Z A:
medalius	m' E . d a . " l' U s	m' E . " d A:_R . l' U s
medicinos	m' E . d' I . " ts' I . n o: s
medienos	m' E . " d' I_F e . n o: s
meditacijas	m' E . d' I . " t A:_R . ts' I . j a s
medžiaga	" m' {:_R . dZ' a . g a	m' E . dZ' a . " g a
medžiagą	" m' {:_R . dZ' a . g A:
medžio	" m' {:_R . dZ' o:
medžių	" m' {:_R . dZ' u:
menininkę	" m' {:_R . n' I . n' I n' . k' {:
mergelę	m' E r' . " g' {:_R . l' {:
mergina	m' E r' . g' I . " n a	m' E r' . " g' I . n a	" m' E_F r' . g' I . n a
merginai	m' E r' . " g' I . n a I
mes	" m' {:_R s	" m' E s
metai	" m' {:_R . t a I
metais	" m' {:_R . t a I s
metalines	m' E . t a . l' I . " n' E s
metaliniai	m' E . t a . " l' I . n' a I	m' E . " t A:_R . l' I . n' a I
metikai	m' E . " t' I . k a I
metu	m' E . " t U
metus	m' E . " t U s	" m' {:_R . t U s
metų	" m' {:_R . t u:
miega	" m' I_F e . g a	" m' I e_R . g a	m' I e . " g a
mielai	m' I e . " 5 a I_R	" m' I_F e . 5 a I
mieloji	m' I e . " 5 o:_F . j I
miestelio	m' I e . " s' t' {:_R . l' o:
miestelis	m' I e . " s' t' {:_R . l' I s
miesto	" m' I e_R . s t o:
miestuose	" m' I e_R . s t U O . s' E
miestus	m' I e . " s t U s
miestą	" m' I e_R . s t A:
miestų	" m' I e_R . s t u:
milijardais	m' I . l' I . " j a_F r . d a I s
milijardas	m' I . l' I . " j a_F r . d a s
milžiniškos	" m' I l'_R . Z' I . n' I . S k o: s
mineraliniai	m' I . n' E . " r A:_R . l' I . n' a I
mineralinės	m' I . n' E . " r A:_R . l' I . n' e: s
minima	m' I . n' I . " m a	" m' I . n' I . m a
ministerija	m' I . n' I . " s' t' E . r' I . j a
ministerijos	m' I . n' I . " s' t' E . r' I . j o: s
ministras	m' I . " n' I . s t r a s
minta	" m' I n_R . t a	m' I n . " t a
minutė	m' I . " n U . t' e:
minutės	m' I . " n U . t' e: s
minučių	m' I . " n U . tS' u:
minėta	m' I . " n' e:_F . t a
miokardo	m' I . j O . " k a_F r . d o:
mirties	m' I r' . " t' I e_R s
misiją	" m' I . s' I . j A:
mišrųjį	" m' I . S r u: . j i:
mobilieji	m O . b' I . " l' I_F e . j I
mobilųjį	m O . " b' I . 5 u: . j i:
modelį	" m O . d' E . l' i:
modernios	m O . " d' E r'_R . n' o: s	m O . d' E r' . " n' o:_R s
moka	" m o:_F . k a
mokesčių	" m o:_F . k' E . S' tS' u:
mokiniai	m o: . k' I . " n' a I_R
mokinys	m o: . k' I . " n' i:_R s
mokomasi	" m o:_F . k o: . m a . s' I
moksleiviai	m o: k . " s' l' E I_R . v' a I
mokslininkai	" m o:_F k . s' l' I . n' I n . k a I
mokslininko	" m o:_F k . s' l' I . n' I n . k o:
mokslininkus	" m o:_F k . s' l' I . n' I n . k U s
mokslinė	" m o:_F k . s' l' I . n' e:
mokslo	" m o:_F k . s 5 o:
mokslu	" m o:_F k . s 5 U
mokyklas	m o: . k' i: . " k 5 a s
mokykloje	m o: . " k' i:_R . k 5 o: . j E
mokyklų	m o: . " k' i:_R . k 5 u:
mokytis	" m o:_F . k' i: . t' I s
mokytojų	" m o:_F . k' i: . t o: . j u:
molis	" m o:_F . l' I s
moteris	" m o:_F . t' E . r' I s
moterys	" m o:_F . t' E . r' i: s
motociklais	m O . t O . " ts' I . k 5 a I s
motyvacija	m O . t' i: . " v A:_R . ts' I . j a
mudu	" m U . d U
mus	" m U s
muziejaus	m U . " z' I e_R . j a U s
muziejus	m U . " z' I e_R . j U s	m U . z' I e . " j U s
muzika	" m U . z' I . k a
muzikantu	m U . z' I . " k a_F n . t U
muzikos	" m U . z' I . k o: s
mylimoji	m' i: . l' I . " m o:_F . j I
myliu	m' i: . " l' U	" m' i:_F . l' U
mąstymas	" m A:_R . s' t' i: . m a s
mėginius	" m' e:_F . g' I . n' U s
mėgstamiausia	m' e: k s . t a . " m' a_F U . s' a
mėgėjus	m' e: . " g' e:_F . j U s
mėlyną	" m' e:_F . l' i: . n A:
mėnesio	" m' e:_F . n' E . s' o:
mėnesį	" m' e:_F . n' E . s' i:
mėnuo	" m' e:_F . n U O
mėsa	m' e: . " s a	" m' e:_R . s a
mūsų	" m u:_F . s u:
mūšio	" m u:_R . S' o:
nacionalinis	n a . ts' I . j O . " n A:_R . l' I . n' I s	n a . ts' O . " n A:_R . l' I . n' I s
nakties	n a k . " t' I e_R s
naktį	" n A:_R k . t' i:
namo	n a . " m o:_R
namuose	n a . m U O . " s' E
namus	n a . " m U s
namų	n a . " m u:_R
nanotechnologijos	n A: . n O . t' E x . n O . " 5 O . g' I . j o: s
nario	" n A:_R . r' o:
narių	n a . " r' u:_R
narkotikus	n a r . " k O . t' I . k U s
natūralių	n a . t u: . r a . " l' u:_R
naudos	n a U . " d o:_R s
naudotojai	n a U . " d o:_F . t o: . j a I
naudą	" n a_F U . d A:	" n a U_R . d A:
nauja	n a U . " j a	" n a U_R . j a
naujas	" n a U_R . j a s
naujo	" n a U_R . j o:
naujomis	n a U . j o: . " m' I s
naują	" n a U_R . j A:
naujų	n a U . " j u:_R
ne	" n' E
neatitaisomos	n' E . a . t' I . " t a I_R . s o: . m o: s
neauga	n' E . " a_F U . g a
nebeauga	n' E . b' E . " a_F U . g a
nebepavyksta	n' E . b' E . p a . " v' i:_R k . s t a
nebežinodamas	n' E . b' E . Z' I . " n o:_F . d a . m a s
nebijo	n' E . " b' I . j o:
neblizgios	n' E . " b' l' I . z' g' o: s	n' E . b' l' I . " z' g' o:_R s
nedidelio	n' E . " d' I . d' E . l' o:
nedidelės	n' E . " d' I . d' E . l' e: s
nedžabyk	n' E . " dZ A:_R . b' i: k
negailėjo	n' E . g a I . " l' e:_F . j o:
negali	n' E . g a . " l' I	n' E . " g A:_R . l' I
negalintys	n' E . " g A:_R . l' I n' . t' i: s
negalėjo	n' E . g a . " l' e:_F . j o:
negerai	n' E . g' E . " r a I_R	n' E . " g' {:_R . r a I
nei	" n' E I_R
neišlaikyto	n' E . I S . 5 a I . " k' i:_F . t o:
neišsipiltų	n' E . I . s' I . " p' I 5_R . t u:	n' E . I . s' I . p' I 5 . " t u:_R	n' E . I S' . s' I . " p' I 5_R . t u:	n' E . I S' . s' I . p' I 5 . " t u:_R
neklausysi	n' E . k 5 a U . " s' i:_F . s' I
neklaužadą	n' E . " k 5 a_F U . Z a . d A:
nekvalifikuotos	n' E . k v a . l' I . f' I . " k U_F O . t o: s
nekvėpavus	n' E . k v' e: . " p A:_R . v U s
nelaimes	n' E . " 5 a_F I . m' E s
nelaimingam	n' E . 5 a I . " m' I_F n . g a m
nelaukiama	n' E . " 5 a_F U . k' a . m a	n' E . 5 a U . k' a . " m a
neleidžia	n' E . " l' E_F I . dZ' a
nematerialią	n' E . m a . t' E . " r' A:_R . l' A:
nemačiusi	n' E . " m A:_R . tS' U . s' I
nemažai	n' E . " m A:_R . Z a I	n' E . m a . " Z a I_R
nemiela	n' E . " m' I_F e . 5 a	n' E . m' I e . " 5 a
nenaudojimu	n' E . n a U . " d o:_F . j I . m U
nenori	n' E . " n o:_F . r' I	n' E . n o: . " r' I
neoklasicistiniai	n' E . O . k 5 a . s' I . " ts' I . s' t' I . n' a I
nepagrįsti	n' E . p a . " g r' i:_R . s' t' I	n' E . p a . g r' i: . " s' t' I
nepakanka	n' E . p a . " k a n_R . k a
nepakankamai	n' E . p a . " k a n_R . k a . m a I
nepamiršti	n' E . p a . m' I r' . " S' t' I
nepopuliari	n' E . p O . p U . l' a . " r' I
nepriklausomybės	n' E . p' r' I . k 5 a U . s o: . " m' i:_F . b' e: s
nepriklausomybę	n' E . p' r' I . k 5 a U . s o: . " m' i:_F . b' {:
nepritaria	n' E . " p' r' I . t a . r a
neranda	n' E . " r a n_R . d a
nereikalingas	n' E . r' E I . k a . " l' I_F n . g a s
nereikalingų	n' E . r' E I . k a . " l' I_F n . g u:
nereiklūs	n' E . " r' E I_R . k 5 u: s
neretai	n' E . r' E . " t a I_R	n' E . " r' {:_R . t a I
nes	" n' E s
neseniai	n' E . s' E . " n' a I_R
neskelbs	n' E . " s' k' E 5_R p s
nesugeba	n' E . " s U . g' E . b a
nesėkmės	n' E . s' e: k . " m' e:_R s	" n' {:_R . s' e: k . m' e: s
net	" n' E t
netiko	n' E . " t' I . k o:
netikėtai	n' E . t' I . " k' e:_F . t a I
netrūksta	n' E . " t r u:_F k . s t a
neturi	n' E . t U . " r' I	n' E . " t U . r' I
neturėjo	n' E . t U . " r' e:_F . j o:
neturėję	n' E . t U . " r' e:_F . j {:
neužsikrėstų	n' E . U . s' I . " k r' e:_R . s t u:	n' E . U . s' I . k r' e: . " s t u:_R	n' E . U S' . s' I . " k r' e:_R . s t u:	n' E . U S' . s' I . k r' e: . " s t u:_R
nevidone	n' E . v' I . " d o:_R . n' E
neįmanoma	n' E . i: . " m A:_R . n o: . m a
neįtikėtinų	n' E . i: . t' I . " k' e:_F . t' I . n u:
neįvykdymą	n' E . i: . " v' i:_F g . d' i: . m A:
nešdami	n' E . Z d a . " m' I
nešiausi	n' E . " S' a U_R . s' I
nešini	n' E . S' I . " n' I
nežinomoji	n' E . " Z' I . n o: . m o: . j I	n' E . Z' I . n o: . " m o:_F . j I
niekada	n' I e . k a . " d a
niekaip	" n' I e_R . k a I p
niekuo	n' I e . " k U O_R
niūrokas	n' u: . " r o:_R . k a s
noras	" n o:_F . r a s
norinčių	" n o:_F . r' I n' . tS' u:
nors	" n O_F r s
noru	" n o:_F . r U	n o: . " r U
norėčiau	n o: . " r' e:_F . tS' a U
nudraskė	n U . " d r A:_R . s' k' e:
nudžabalijau	n U . dZ a . " b A:_R . l' I . j a U
nudžabalijo	n U . dZ a . " b A:_R . l' I . j o:
nudžabysiu	n U . " dZ A:_R . b' i: . s' U
nudžabyti	n U . " dZ A:_R . b' i: . t' I
nufilmuotas	n U . f' I 5 . " m U_F O . t a s
nugalėjo	n U . g a . " l' e:_F . j o:
nukentėjusiems	n U . k' E n' . " t' e:_F . j U . s' I e m s
nukritę	n U . " k r' I . t' {:
nukrypsta	n U . " k r' i:_R p . s t a
nulis	n U . " l' I s
numeris	" n U . m' E . r' I s
numesti	n U . " m' E . s' t' I	n U . m' E . " s' t' I
numetęs	n U . " m' {:_R . t' {: s
nuo	" n U O_R
nuolat	n U O . " 5 a t	" n U O_R . 5 a t
nuomones	" n U_F O . m o: . n' E s
nuosavuose	n U O . s a . v U O . " s' E
nuosavą	" n U_F O . s a . v A:
nuostabūs	n U O . " s t A:_R . b u: s
nuostolius	" n U_F O . s t o: . l' U s
nuotaikomis	" n U_F O . t a I . k o: . m' I s
nuotaikų	" n U_F O . t a I . k u:
nuotykių	" n U_F O . t' i: . k' u:
nusako	n U . " s A:_R . k o:
nusifilmavusi	n U . s' I . f' I 5 . " m A:_R . v U . s' I
nusipelnė	n U . s' I . " p' E l'_R . n' e:
nusiperka	n U . " s' I . p' E r . k a
nusipirkti	n U . s' I . " p' I r'_R k . t' I	n U . s' I . p' I r' k . " t' I
nusitrynusios	n U . s' I . " t' r' i:_F . n U . s' o: s
nuslėpusiems	n U . " s' l' e:_R . p U . s' I e m s
nusprendžiau	n U . " s' p' r' E_F n' . dZ' a U
nuspręsta	n U . " s' p' r' {:_F . s t a
nuspėjama	n U . " s' p' e:_F . j a . m a	n U . s' p' e: . j a . " m a
nustatytas	n U . s t a . " t' i:_F . t a s
nustojo	n U . " s t o:_F . j o:
nuvažiavome	n U . v a . " Z' A:_R . v o: . m' E
nuveiktus	" n U . v' E I k . t U s
nuveikus	n U . " v' E I_R . k U s
nėra	n' e: . " r a
nūdienos	n u: . d' E . " n o:_R s	" n u:_R . d' E . n o: s
o	" O	" o:_R
objektas	O b' . " j E k . t a s	" O b' . j E k . t a s
objektyvių	O b' . j E k . t' i: . " v' u:_R
objektų	O b' . " j E k . t u:
obuoliais	o: . b U O . " l' a I_R s
odontologų	O . d O n . t O . " 5 O . g u:
oficialiai	O . f' I . ts' I . j a . " l' a I_R	O . f' I . ts' a . " l' a I_R
oi	" O_F I
olimpiadoje	O . l' I m' . p' I . " j A:_R . d o: . j E
operacijos	O . p' E . " r A:_R . ts' I . j o: s
opozicija	O . p O . " z' I . ts' I . j a
orai	o: . " r a I_R
orams	o: . " r a_F m s
orda	" O_F r . d a
organizacijų	O r . g a . n' I . " z A:_R . ts' I . j u:
orkestro	O r' . " k' E s t . r o:
oro	" o:_F . r o:
orą	" o:_F . r A:
paauglių	p a . a U . " g l' u:_R
paauglystės	p a . a U . " g l' i:_R . s' t' e: s
pabrėžė	" p a . b' r' e: . Z' e:
pacientas	p a . ts' I . " E n_R . t a s
padaryti	p a . d a . " r' i:_F . t' I
padarė	p a . " d A:_R . r' e:
padaręs	p a . " d A:_R . r' {: s
padeda	" p a . d' E . d a
padidinti	p a . " d' I . d' I n' . t' I
padėjėjai	p a . d' e: . " j e:_F . j a I
padėkojome	p a . d' e: . " k o:_F . j o: . m' E
padėtis	p a . d' e: . " t' I s
padėtų	p a . " d' e:_F . t u:
pagal	" p A:_R . g a 5	p a . " g a 5_R
pagalbą	p a . " g a_F 5 . b A:
pagarsink	p a . " g a_F r' . s' I n k	p a . " g a r'_R . s' I n k
pagausėja	p a . g a U . " s' e:_F . j a
pagerbti	p a . " g' E r'_R p' . t' I	p a . g' E r' p' . " t' I
pagrindinio	p a . g r' I n' . " d' I . n' o:
pagrindinis	p a . g r' I n' . " d' I . n' I s
pagrindiniu	p a . g r' I n' . d' I . " n' U
pajėgumų	p a . j e: . " g U . m u:
pakaitalai	p a . k a I . t a . " 5 a I_R
pakankamai	p a . " k a n_R . k a . m a I
pakaunėje	p a . k a U . n' e: . " j E
pakiliomis	p a . k' I . l' o: . " m' I s
paklausa	p a . k 5 a U . " s a
paklausos	p a . k 5 a U . " s o:_R s
pakrantės	p a . " k r a_F n' . t' e: s
pakrantėse	p a . " k r a_F n' . t' e: . s' E
pakrančių	p a . " k r a_F n' . tS' u:
pakraščių	p a . k r a . " S' tS' u:_R
palankių	p a . 5 a n' . " k' u:_R
paleisti	p a . " l' E_F I . s' t' I	p a . l' E I . " s' t' I
palikti	p a . " l' I k . t' I	p a . l' I k . " t' I
palydimas	p a . " l' i:_R . d' I . m a s
pamatę	p a . " m A:_R . t' {:
pamestą	" p a . m' E . s t A:
pametė	" p a . m' E . t' e:
paminėjo	p a . m' I . " n' e:_F . j o:
paminėtas	p a . m' I . " n' e:_F . t a s
pamiršo	p a . " m' I r_R . S o:
pamiršę	p a . " m' I r'_R . S' {:
pamoka	p a . m o: . " k a
panaikinti	p a . n a I . " k' I_F n' . t' I
panaudojimas	p a . n a U . " d o:_F . j I . m a s
panaudojimą	p a . n a U . " d o:_F . j I . m A:
panele	p a . n' E . " l' E	p a . " n' {:_R . l' E
panelė	p a . " n' {:_R . l' e:
papildomą	p a . " p' I_F 5 . d o: . m A:
paplitusios	p a . " p' l' I . t U . s' o: s
paplitęs	p a . " p' l' I . t' {: s
paprasta	p a . p r a . " s t a	" p a . p r a . s t a
paprastai	" p a . p r a . s t a I	p a . p r a . " s t a I_R
paprašyti	p a . p r a . " S' i:_F . t' I
parama	p a . r a . " m a	" p A:_R . r a . m a
parapijiečiai	p a . r a . p' I . " j I e_R . tS' a I
parašyti	p a . r a . " S' i:_F . t' I
parašė	p a . " r A:_R . S' e:
pardavėjams	p a r . d a . " v' e:_F . j a m s
parduoti	p a r . " d U_F O . t' I	p a r . d U O . " t' I
pareigūnams	p a . r' E I . " g u:_R . n a m s
parkas	" p a_F r . k a s
parke	" p a_F r' . k' E
parką	" p a_F r . k A:
paroda	p a . r o: . " d a
parodyti	p a . " r o:_F . d' i: . t' I
paruošė	" p a . r U O . S' e:
pas	" p a s
pasakiau	p a . s a . " k' a U_R
pasakojo	" p A:_R . s a . k o: . j o:
pasakykite	p a . s a . " k' i:_F . k' I . t' E
pasakėme	p a . " s A:_R . k' e: . m' E
pasauliniam	p a . " s a_F U . l' I . n' a m
pasaulio	p a . " s a_F U . l' o:
pasaulis	p a . " s a_F U . l' I s
pasaulyje	p a . " s a_F U . l' i: . j E
pasaulį	p a . " s a_F U . l' i:
pasekmes	" p A:_R . s' E k . m' E s
pasibaigus	p a . s' I . " b a I_R . g U s
pasiekia	p a . " s' I_F e . k' a
pasieksite	p a . " s' I_F e k . s' I . t' E
pasikeitusi	p a . s' I . " k' E I_R . t U . s' I
pasiklysta	p a . s' I . " k l' i:_F . s t a
pasimėgauti	p a . s' I . " m' e:_F . g a U . t' I
pasipuošęs	p a . s' I . " p U O_R . S' {: s
pasirodo	p a . s' I . " r o:_F . d o:
pasirodė	p a . s' I . " r o:_F . d' e:
pasirodęs	p a . s' I . " r o:_F . d' {: s
pasisako	p a . s' I . " s A:_R . k o:
pasisekimo	p a . s' I . s' E . " k' I . m o:
pasitarsime	p a . s' I . " t a r'_R . s' I . m' E
pasitinka	p a . s' I . " t' I n_R . k a
pasitraukė	p a . s' I . " t r a_F U . k' e:
pasivažinėti	p a . s' I . v a . Z' I . " n' e:_F . t' I
pasiūla	p a . s' u: . " 5 a
pasižymi	p a . s' I . Z' i: . " m' I	p a . s' I . " Z' i:_R . m' I
pasižymėjo	p a . s' I . Z' i: . " m' e:_F . j o:
paskatintas	p a . " s k A:_R . t' I n . t a s
paskirtį	" p A:_R . s' k' I r' . t' i:
paskutiniai	p a . s k U . " t' I . n' a I
paskutiniam	p a . s k U . " t' I . n' a m
paskutiniame	p a . s k U . " t' I . n' a . m' E
paslaptis	p a . s 5 a p' . " t' I s	" p A:_R . s 5 a p' . t' I s
pastabus	p a . s t a . " b U s
pastaruoju	p a . s t a . " r U_F O . j U
pastatyta	p a . s t a . " t' i:_F . t a
pastatyti	p a . s t a . " t' i:_F . t' I
pat	" p a t
patikimi	p a . t' I . k' I . " m' I
patikimumą	p a . t' I . k' I . " m U . m A:
patikėtas	p a . t' I . " k' e:_F . t a s
patiriame	" p a . t' I . r' a . m' E
patogeniškumo	p a . t O . g' E . n' I . " S k U . m o:
patogesnėmis	p a . t o: . g' E . s' n' e: . " m' I s
patyrė	p a . " t' i:_F . r' e:
patys	" p A:_R . t' i: s
paukštiena	p a U k . " S' t' I_F e . n a
paukštienos	p a U k . " S' t' I_F e . n o: s
paukščius	p a U k . " S' tS' U s
paukščių	" p a U_R k . S' tS' u:
pavadintas	p a . v a . " d' I_F n . t a s
pavartotas	p a . v a r . " t o:_F . t a s
paversti	p a . v' E r' . " s' t' I	p a . " v' E r'_R . s' t' I
paviešėję	p a . v' I e . " S' e:_F . j {:
paviršiaus	p a . " v' I r'_R . S' a U s
pavojingiausių	p a . v o: . j I n' . " g' a_F U . s' u:
pavyko	p a . " v' i:_R . k o:
pavyzdys	p a . v' i: . " z' d' i:_R s
pačiais	p a . " tS' a I_R s
pačiame	p a . tS' a . " m' E
pačios	p a . " tS' o:_R s	" p A:_R . tS' o: s
pašalpas	" p A:_R . S a 5 . p a s
pašnekovą	p a . S' n' E . " k o:_R . v A:
pašvaistės	p a . " S v a I_R . s' t' e: s
pažeidžiama	p a . Z' E I . dZ' a . " m a	p a . " Z' E I_R . dZ' a . m a
pažeidžiant	p a . " Z' E I_R . dZ' a n t
pažymėti	p a . Z' i: . " m' e:_F . t' I
peiliai	" p' E I_R . l' a I
peiliu	p' E I . " l' U
peizažais	p' E I . " z A:_R . Z a I s
pendešimt	" p' E n'_R . d' E . S' I m t
penki	p' E n' . " k' I
penkias	p' E n' . " k' a s
penkiasdešimt	p' E n' . k' a z' . " d' {:_R . S' I m t	" p' E n'_R . k' a z' . d' {: . S' I m t
penkiasdešimtųjų	p' E n' . k' a z' . " d' {:_R . S' I m . t u: . j u:	p' E n' . k' a z' . d' E . S' I m . " t u:_R . j u:
penkiolika	p' E n' . " k' o:_F . l' I . k a
penkiolikta	p' E n' . " k' o:_F . l' I k . t a
penkioliktoji	p' E n' . " k' o:_F . l' I k . t o: . j I
penkios	" p' E n'_R . k' o: s
penkių	p' E n' . " k' u:_R
penkta	p' E n k . " t a	" p' E n_R k . t a
penktadienis	p' E n k . " t A:_R . d' I e . n' I s
penkti	p' E n' k . " t' I
penktų	p' E n k . " t u:_R
penktųjų	p' E n k . " t u:_R . j u:
penkšimt	" p' E n'_R k . S' I m t
pensijų	" p' E n'_R . s' I . j u:
per	" p' E r_R
pergale	" p' E_F r . g a . l' E
pergalė	" p' E_F r . g a . l' e:
pergyvena	" p' E_F r' . g' i: . v' E . n a
perkamo	" p' E r_R . k a . m o:
perkelti	" p' E_F r' . k' E l' . t' I
perlenkiama	" p' E_F r' . l' E n' . k' a . m a
perlui	" p' E r_R . 5 U i
pernai	" p' E_F r . n a I
perplaukę	" p' E_F r . p 5 a U . k' {:
perskaityta	" p' E_F r . s k a I . t' i: . t a
perspėjo	" p' E_F r' . s' p' e: . j o:
pertraukiantis	" p' E_F r . t r a U . k' a n' . t' I s
pertvarka	" p' E_F r . t v a r . k a
picų	" p' I . ts u:
pieninė	" p' I e_R . n' I . n' e:
pietų	p' I e . " t u:_R	" p' I e_R . t u:
pigesnę	p' I . " g' E . s' n' {:
pigi	p' I . " g' I
piktnaudžiavimu	p' I k . t n a U . " dZ' A:_R . v' I . m U
piliečiai	p' I . " l' I e_R . tS' a I
pin	" p' I_F n
piniginė	p' I . n' I . " g' I . n' e:
pinigus	" p' I . n' I . g U s
pinigų	p' I . n' I . " g u:_R
pirma	" p' I_F r . m a	p' I r . " m a
pirmadienis	p' I r . " m A:_R . d' I e . n' I s
pirmasis	p' I r . " m a . s' I s
pirmi	p' I r' . " m' I
pirmo	" p' I_F r . m o:
pirmoji	p' I r . " m o:_F . j I
pirmos	p' I r . " m o:_R s	" p' I_F r . m o: s
pirmą	" p' I_F r . m A:
pirmų	p' I r . " m u:_R
pirmųjų	p' I r . " m u:_R . j u:
piršliai	p' I r' . " S' l' a I_R
pjauna	" p' j a_F U . n a
plakatai	p 5 a . " k A:_R . t a I
planetai	p 5 a . " n' E . t a I
planetą	p 5 a . " n' E . t A:
planšetinių	p 5 a n' . " S' E . t' I . n' u:
plieno	" p' l' I e_R . n o:
plius	" p' l' U s
pluoštų	" p 5 U_F O . S t u:
plėtojo	p' l' e: . " t o:_F . j o:
plėtoti	p' l' e: . " t o:_F . t' I
plūsta	" p 5 u:_F . s t a
po	" p o:_R
pobūdžio	" p o:_F . b u: . dZ' o:
poilsiautojai	p o: . I l' . " s' a_F U . t o: . j a I
poilsiavo	p o: . I l' . " s' A:_R . v o:
pokalbiai	" p o:_F . k a l' . b' a I
policija	p o: . " l' I . ts' I . j a
policijos	p o: . " l' I . ts' I . j o: s
policiją	p O . " l' I . ts' I . j A:
policininkai	p o: . " l' I . ts' I . n' I n . k a I
policininkų	p O . " l' I . ts' I . n' I n . k u:
politikoje	p O . " l' I . t' I . k o: . j E
politikų	p O . " l' I . t' I . k u:
politinė	p O . " l' I . t' I . n' e:
pone	" p o:_R . n' E
popierinius	p o: . p' I e . r' I . " n' U s	p o: . p' I e . " r' I . n' U s
populiacija	p O . p U . " l' A:_R . ts' I . j a
porcija	" p O_F r' . ts' I . j a
porciją	" p O_F r' . ts' I . j A:
poreikį	" p o:_F . r' E I . k' i:
portaluose	p O r . " t A:_R . 5 U O . s' E
poryt	p o: . " r' i:_F t
posėdžio	" p o:_F . s' e: . dZ' o:
pozicijas	p O . " z' I . ts' I . j a s
požymis	" p o:_F . Z' i: . m' I s
prabilta	p r a . " b' I_F 5 . t a
pradingo	p r a . " d' I n_R . g o:
pradėjo	p r a . " d' e:_F . j o:
pradėjusi	p r a . " d' e:_F . j U . s' I
pradės	p r a . " d' e:_F s
pradėti	p r a . d' e: . " t' I	p r a . " d' e:_F . t' I
pradžia	p r a . " dZ' a
pradžioje	p r a . dZ' o: . " j E
pradžiugino	p r a . " dZ' U . g' I . n o:
pradžią	" p r A:_R . dZ' A:
prakilnybe	p r a . k' I l' . " n' i:_F . b' E
pramoga	p r a . m o: . " g a
prancūzai	p r a n . " ts u:_R . z a I
prancūziški	p r a n . " ts u:_R . z' I . S' k' I
prancūzų	p r a n . " ts u:_R . z u:
pranoko	p r a . " n o:_F . k o:
praraja	p r a . r a . " j a	" p r A:_R . r a . j a
prasidėjus	p r a . s' I . " d' e:_F . j U s
prastesnė	p r a . " s' t' E . s' n' e:
pratęsimo	p r a . t' {: . " s' I . m o:
praūžę	p r a . " u:_R . Z' {:
premjeras	p' r' E . m' I . " j E . r a s	p' r' E m' . " j E . r a s
prezidentas	p' r' E . z' I . " d' E n_R . t a s	p' r' E . " z' I . d' E n . t a s
prezidento	p' r' E . z' I . " d' E n_R . t o:
prezidentė	p' r' E . z' I . " d' E n'_R . t' e:	p' r' E . " z' I . d' E n' . t' e:
prie	" p' r' I e_R
priemone	" p' r' I_F e . m o: . n' E
priemonių	" p' r' I_F e . m o: . n' u:
prieteli	" p' r' I_F e . t' E . l' I
prieš	" p' r' I e_R S
priešraketinės	p' r' I e S . r a . " k' E . t' I . n' e: s
priežasčių	p' r' I e . Z a . " S' tS' u:_R
priežiūra	" p' r' I_F e . Z' u: . r a
prigrūsta	p' r' I . g r u: . " s t a	p' r' I . " g r u:_F . s t a
priklauso	p' r' I . " k 5 a U_R . s o:
primena	" p' r' I . m' E . n a
priminė	" p' r' I . m' I . n' e:
pripažino	p' r' I . p a . " Z' I . n o:
pripažintais	p' r' I . p a . Z' I n . " t a I_R s	p' r' I . p a . " Z' I_F n . t a I s
pripažinti	p' r' I . p a . " Z' I_F n' . t' I	p' r' I . p a . Z' I n' . " t' I
prirašyta	p' r' I . r a . " S' i:_F . t a
prireikė	" p' r' I . r' E I . k' e:
prisidėję	p' r' I . s' I . " d' e:_F . j {:
prisikėlimo	p' r' I . s' I . k' e: . " l' I . m o:
prisitraukti	p' r' I . s' I . " t r a_F U k . t' I	p' r' I . s' I . t r a U k . " t' I
pristatomas	p' r' I . " s t A:_R . t o: . m a s
pristatyti	p' r' I . s t a . " t' i:_F . t' I
pristatė	p' r' I . " s t A:_R . t' e:
privatumo	p' r' I . v a . " t U . m o:
privačių	p' r' I . v a . " tS' u:_R
priversti	p' r' I . " v' E r'_R . s' t' I	p' r' I . v' E r' . " s' t' I
priverčia	p' r' I . " v' E r'_R . tS' a
prizas	" p' r' I . z a s
probiotikai	p r O . b' I . " j O . t' I . k a I
problemų	p r O . " b' l' E . m u:
procedūros	p r O . ts' E . " d u:_R . r o: s
procedūrų	p r O . ts' E . " d u:_R . r u:
procentai	" p r O . ts' E n . t a I	p r O . " ts' E n_R . t a I
procentų	" p r O . ts' E n . t u:	p r O . " ts' E n_R . t u:
produkcijoje	p r O . " d U k . ts' I . j o: . j E
produktyvesnį	p r O . d U k . t' i: . " v' E . s' n' i:
produktų	p r O . " d U k . t u:	" p r O . d U k . t u:
profesijų	p r O . " f' E . s' I . j u:
profesionalai	p r O . f' E . s' O . " n A:_R . 5 a I
profesionalais	p r O . f' E . s' O . " n A:_R . 5 a I s
profesionalų	p r O . f' E . s' O . " n A:_R . 5 u:
prognozuojamas	p r O g . n O . " z U_F O . j a . m a s
programa	p r O . g r a . " m a
programoje	p r O . " g r A:_R . m o: . j E
programą	p r O . " g r A:_R . m A:
projektais	p r O . " j E k . t a I s
protestas	p r O . " t' E . s t a s	" p r O . t' E . s t a s
provincijoje	p r O . " v' I_F n' . ts' I . j o: . j E
provincijos	p r O . " v' I_F n' . ts' I . j o: s
proziniai	" p r O . z' I . n' a I
publikaciją	p U . b' l' I . " k A:_R . ts' I . j A:
puikiai	" p U i_R . k' a I
puikių	p U i . " k' u:_R
pusė	" p U . s' e:
pusėje	" p U . s' e: . j E
pusės	" p U . s' e: s
pusę	" p U . s' {:
pėdsekį	" p' e:_F t' . s' E . k' i:
radarą	r a . " d A:_R . r A:
radiją	" r A:_R . d' I . j A:
raidė	" r a I_R . d' e:	r a I . " d' e:_R
raiteliai	" r a I_R . t' E . l' a I
rajono	r a . " j O . n o:
rajonų	r a . " j O . n u:
raketas	r a . k' E . " t a s	r a . " k' E . t a s
ramios	r a . " m' o:_R s	" r A:_R . m' o: s
raudona	r a U . " d o:_F . n a	r a U . d o: . " n a
raudonų	r a U . " d o:_F . n u:	r a U . d o: . " n u:_R
rašytojai	r a . " S' i:_F . t o: . j a I
rašytojas	r a . " S' i:_F . t o: . j a s
reakcijomis	r' E . " A:_R k . ts' I . j o: . m' I s
reakciją	r' E . " A:_R k . ts' I . j A:
realizavusi	r' E . a . l' I . " z A:_R . v U . s' I
reanimacijoje	r' E . a . n' I . " m A:_R . ts' I . j o: . j E
recesija	r' E . " ts' E . s' I . j a
referendumui	r' E . f' E . " r' E n_R . d U . m U i
reformos	r' E . " f O_F r . m o: s
regiono	r' E . g' I . " j O . n o:
regionų	r' E . g' I . " j O . n u:
reglamentuota	r' E . g 5 a . m' E n . " t U_F O . t a
reikalavimus	r' E I . k a . " 5 A:_R . v' I . m U
reikalavimų	r' E I . k a . " 5 A:_R . v' I . m u:
reikia	" r' E I_R . k' a
reiškiniai	r' E I . S' k' I . " n' a I_R
reklaminis	r' E . " k 5 A:_R . m' I . n' I s
reklamą	r' E . " k 5 A:_R . m A:
rekonstruoti	r' E . k O n . " s t r U_F O . t' I
reliatyvizmo	r' E . l' a . t' i: . " v' I . z m o:
remiantys	" r' {:_R . m' a n' . t' i: s
renginyje	r' E n' . g' I . n' i: . " j E
reprezentacines	r' E . p' r' E . z' E n . " t A:_R . ts' I . n' E s
reta	r' E . " t a	" r' {:_R . t a
revanšiškų	r' E . " v a_F n' . S' I . S k u:
rezultatų	r' E . z U 5 . " t A:_R . t u:
rečiau	r' E . " tS' a U_R
riaušių	" r' a_F U . S' u:
ribos	" r' I . b o: s	r' I . " b o:_R s
ribų	r' I . " b u:_R
rimtą	" r' I m_R . t A:
rinkimai	r' I n' . " k' I . m a I
rinkimų	r' I n' . " k' I . m u:
rinkosi	" r' I n_R . k o: . s' I
rinktinės	r' I n' k . " t' I . n' e: s
riterių	" r' I . t' E . r' u:
rizika	" r' I . z' I . k a
rizikingesniems	r' I . z' I . k' I n' . g' E . " s' n' I_F e m s
rizikuoti	r' I . z' I . " k U_F O . t' I
riziką	" r' I . z' I . k A:
robotą	" r O . b O . t A:
rodė	" r o:_F . d' e:
rožėmis	" r o:_R . Z' e: . m' I s
rudens	r U . " d' E n_R s
rugpjūtį	r U k . " p' j u:_F . t' i:
rugpjūčio	r U k . " p' j u:_F . tS' o:
rugsėjo	r U k . " s' e:_F . j o:
rungtyse	r U n' k . t' i: . " s' E
ruošti	" r U O_R . S' t' I	r U O . " S' t' I
rykliai	r' i: . " k l' a I_R
rytas	" r' i:_F . t a s
rytinės	r' i: . " t' I . n' e: s
ryto	" r' i:_F . t o:
rytoj	r' i: . " t O_F j
rytuose	r' i: . t U O . " s' E
ryškiaspalviai	r' i: . S' k' a . " s p a l'_R . v' a I
ryškiausias	r' i: . " S' k' a_F U . s' a s
ryšys	r' i: . " S' i:_R s
rūmai	" r u:_F . m a I
rūmais	" r u:_F . m a I s
rūšis	r u: . " S' I s
sakiniai	s a . k' I . " n' a I_R
saldikliai	s a l' . " d' I . k l' a I
saloje	s a . 5 o: . " j E
samprata	" s a_F m . p r a . t a
sanitarinių	s a . n' I . " t A:_R . r' I . n' u:
santykį	" s a_F n' . t' i: . k' i:
sapnas	" s A:_R p . n a s
saugia	s a U . " g' a
sausio	" s a U_R . s' o:
sausros	s a U . " s r o:_R s	" s a U_R . s r o: s
savaitgaliui	s a . " v a_F I d . g a . l' U i
savaitgalį	s a . " v a_F I d . g a . l' i:
savaitę	s a . " v a_F I . t' {:
savarankiškai	s a . v a . " r a n'_R . k' I . S k a I
savavališkai	s a . v a . " v A:_R . l' I . S k a I
save	s a . " v' E
savimi	s a . v' I . " m' I
savitu	" s A:_R . v' I . t U
savivaldos	s a . " v' I . v a 5 . d o: s
savo	" s a . v o:
savybių	s a . " v' i:_F . b' u:
savybėmis	s a . " v' i:_F . b' e: . m' I s
savyje	s a . v' i: . " j E
savąja	s a . " v A:_R . j a
scenarijus	s' ts' E . " n A:_R . r' I . j U s
seilių	" s' E_F I . l' u:
sekmadienis	s' E k . " m A:_R . d' I e . n' I s
sekmadienį	s' E k . " m A:_R . d' I e . n' i:
sektinas	" s' E k . t' I . n a s
sektoriams	" s' E k . t O . r' a m s
sektoriaus	" s' E k . t O . r' a U s
sektorius	" s' E k . t O . r' U s
sekundes	s' E . " k U_F n' . d' E s
seminaras	s' E . m' I . " n A:_R . r a s
seniausieji	s' E . " n' a_F U . s' I e . j I
seniausių	s' E . " n' a_F U . s' u:
seniūnui	s' E . " n' u:_R . n U i
senovinės	s' E . " n o:_F . v' I . n' e: s
senovės	s' E . " n o:_F . v' e: s
senu	s' E . " n U
senutė	s' E . " n U . t' e:
senėja	s' E . " n' e:_F . j a
senų	s' E . " n u:_R
septinta	s' E p' . t' I n . " t a
septintais	s' E p' . t' I n . " t a I_R s
septinti	s' E p' . t' I n' . " t' I
septintoji	s' E p' . t' I n . " t o:_F . j I
septintą	s' E p' . " t' I n_R . t A:
septintų	s' E p' . t' I n . " t u:_R
septintųjų	s' E p' . t' I n . " t u:_R . j u:
septyni	s' E p' . t' i: . " n' I
septyniasdešimt	s' E p' . " t' i:_F . n' a z' . d' {: . S' I m t
septyniasdešimtų	s' E p' . t' i: . n' a . z' d' E . S' I m . " t u:_R
septyniasdešimtųjų	s' E p' . t' i: . n' a z' . d' E . S' I m . " t u:_R . j u:
septyniolika	s' E p' . t' i: . " n' o:_F . l' I . k a
septyniolikos	s' E p' . t' i: . " n' o:_F . l' I . k o: s
septyniolikta	s' E p' . t' i: . " n' o:_F . l' I k . t a
septynios	s' E p' . " t' i:_F . n' o: s
septynis	s' E p' . " t' i:_F . n' I s
septynių	s' E p' . t' i: . " n' u:_R	s' E p' . " t' i:_F . n' u:
serbentų	s' E r' . " b' E n_R . t u:
servisas	" s' E_F r' . v' I . s a s
sesijos	" s' E . s' I . j o: s
sezamai	s' E . " z A:_R . m a I
sezoninio	s' E . " z O . n' I . n' o:
sezoniškumas	s' E . z O . n' I . " S k U . m a s
si	" s' I
siaurose	s' a U . r o: . " s' E
siautėjęs	" s' a_F U . t' e: . j {: s
sieja	" s' I_F e . j a	" s' I e_R . j a
siekė	" s' I_F e . k' e:
sielą	" s' I_F e . 5 A:
sienų	" s' I_F e . n u:
simbolinę	s' I m . " b O . l' I . n' {:
simboliu	" s' I m_R . b O . l' U
simbolizavo	s' I m . b O . l' I . " z A:_R . v o:
sionalais	s' I . j O . " n A:_R . 5 a I s
sistema	s' I . s' t' E . " m a
sistemos	s' I . " s' t' E . m o: s
situacijoje	s' I . t U . " A:_R . ts' I . j o: . j E
situacijos	s' I . t U . " A:_R . ts' I . j o: s
siūlo	" s' u:_F . 5 o:
siūlome	" s' u:_F . 5 o: . m' E
siųsdavo	" s' u:_R . z d a . v o:
skaitmeniniu	s k a I . t' m' E . n' I . " n' U
skaito	" s k a I_R . t o:
skaitymas	" s k a I_R . t' i: . m a s
skaitytojai	s k a I . " t' i:_F . t o: . j a I
skaičius	s k a I . " tS' U s	" s k a I_R . tS' U s
skalūninių	s k a . " 5 u:_R . n' I . n' u:
skandinavų	s k a n' . d' I . " n A:_R . v u:
skaudžiausios	s k a U . " dZ' a_F U . s' o: s
skelbimas	s' k' E l' . " b' I . m a s
skelbtą	" s' k' E_F 5 p . t A:
skiriamas	" s' k' I . r' a . m a s
skirta	s' k' I r . " t a
skirtas	" s' k' I_F r . t a s	" s' k' I r_R . t a s	s' k' I r . " t a s
skirtumai	" s' k' I_F r . t U . m a I
sklandžiai	" s k 5 a n'_R . dZ' a I
skola	s k o: . " 5 a	" s k o:_R . 5 a
skolintojams	" s k o:_R . l' I n . t o: . j a m s
skolą	" s k o:_R . 5 A:
skurdžioj	s k U r' . " dZ' O_R j
skylė	s' k' i: . " l' e:_R	" s' k' i:_F . l' e:
skyriaus	" s' k' i:_R . r' a U s	" s' k' i:_F . r' a U s
skyrius	" s' k' i:_R . r' U s	s' k' i: . " r' U s
skųsdavosi	" s k u:_F . z d a . v o: . s' I
sloga	s 5 o: . " g a	" s 5 o:_R . g a
smagiose	s m a . g' o: . " s' E
smerkia	" s' m' E r'_R . k' a
smilčių	" s' m' I_F l' . tS' u:	s' m' I l' . " tS' u:_R
smulkmenas	" s m U_F l' k . m' E . n a s
smulkmenomis	" s m U_F l' k . m' E . n o: . m' I s
smulkus	" s m U_F 5 . k U s
smurto	" s m U_F r . t o:
smėlis	" s' m' e:_R . l' I s
socialinis	s O . ts' I . " j A:_R . l' I . n' I s	s O . " ts' A:_R . l' I . n' I s
socialinė	s O . ts' I . " j A:_R . l' I . n' e:	s O . " ts' A:_R . l' I . n' e:
socialinės	s O . ts' I . " j A:_R . l' I . n' e: s	s O . " ts' A:_R . l' I . n' e: s
socialinį	s O . ts' I . " j A:_R . l' I . n' i:	s O . " ts' A:_R . l' I . n' i:
socialistinis	s O . ts' I . j a . " l' I . s' t' I . n' I s	s O . ts' a . " l' I . s' t' I . n' I s
soda	s O . " d a	" s O . d a
sode	s o: . " d' E	" s o:_R . d' E
sodo	" s o:_R . d o:
sofistų	s O . " f' I . s t u:
sostinė	" s o:_F . s' t' I . n' e:
spalio	" s p A:_R . l' o:
spalvos	" s p a 5_R . v o: s	s p a 5 . " v o:_R s
sparčiai	" s p a r'_R . tS' a I	s p a r' . " tS' a_F I
specialiojoje	s' p' E . ts' I . j a . " l' o:_F . j o: . j E	s' p' E . ts' a . " l' o:_F . j o: . j E
specialistai	s' p' E . ts' I . j a . " l' I . s t a I	s' p' E . ts' a . " l' I . s t a I
specialistė	s' p' E . ts' I . j a . " l' I . s' t' e:	s' p' E . ts' a . " l' I . s' t' e:
specialistų	s' p' E . ts' I . j a . " l' I . s t u:	s' p' E . ts' a . " l' I . s t u:
specialų	s' p' E . ts' I . " j A:_R . 5 u:	s' p' E . " ts' A:_R . 5 u:
specifinis	s' p' E . " ts' I . f' I . n' I s
sportas	" s p O_F r . t a s
sporto	" s p O_F r . t o:
sportuodami	s p O r . " t U_F O . d a . m' I
sprendimų	s' p' r' E n' . " d' I . m u:
sprogimą	s p r o: . " g' I . m A:
srities	s' r' I . " t' I e_R s
sritis	s' r' I . " t' I s
staigmenas	" s t a I_R g . m' E . n a s
staigmenų	s t a I g . m' E . " n u:_R
stambus	s t a m . " b U s
statinys	s t a . t' I . " n' i:_R s
statusą	" s t A:_R . t U . s A:
statyba	s t a . " t' i:_F . b a
statybininkai	s t a . " t' i:_F . b' I . n' I n . k a I
statybinio	s t a . " t' i:_F . b' I . n' o:
statybos	s t a . " t' i:_F . b o: s
stebimas	" s' t' {:_R . b' I . m a s
stebinančiomis	" s' t' {:_R . b' I . n a n' . tS' o: . m' I s
stebėjome	s' t' E . " b' e:_F . j o: . m' E
stengiamasi	" s' t' E_F n' . g' a . m a . s' I
stiklu	s' t' I . " k 5 U
stipriausias	s' t' I . " p' r' a_F U . s' a s
stiprus	s' t' I . " p r U s
stovyklos	s t o: . " v' i:_R . k 5 o: s
stovėjo	s t o: . " v' e:_F . j o:
streiko	" s' t' r' E I_R . k o:
stresas	" s' t' r' E . s a s
studente	s t U . " d' E n'_R . t' E
su	" s U
substanciją	s U p . " s t a_F n' . ts' I . j A:
sudaro	s U . " d A:_R . r o:
sudaroma	s U . " d A:_R . r o: . m a
sudurti	s U . " d U_F r' . t' I	s U . d U r' . " t' I
sudzingėjo	s U . dz' I n' . " g' e:_F . j o:
sugebėjau	s U . g' E . " b' e:_F . j a U
sugriežtino	s U . " g r' I_F e . S' t' I . n o:
sukauptų	s U . k a U p . " t u:_R	s U . " k a U_R p . t u:
sukilėlių	s U . " k' I . l' e: . l' u:
sukti	" s U k . t' I	s U k . " t' I
sukurti	s U . " k U_F r' . t' I	s U . k U r' . " t' I
sukėlė	s U . " k' e:_F . l' e:
sukūrė	s U . " k u:_F . r' e:
sulaikytas	s U . 5 a I . " k' i:_F . t a s
sulaukė	s U . " 5 a_F U . k' e:
sulaukę	s U . " 5 a_F U k . k' {:
sumažinti	s U . " m A:_R . Z' I n' . t' I
sumažėjo	s U . m a . " Z' e:_F . j o:
sumą	" s U . m A:
sunkus	s U n . " k U s
suorganizavo	s U . O r . g a . n' I . " z A:_R . v o:
supranta	s U . " p r a n_R . t a
surado	s U . " r A:_R . d o:
surengtas	" s U . r' E n k . t a s
surengė	" s U . r' E n' . g' e:
susiaurėjo	s U . s' a U . " r' e:_F . j o:
susidariusi	s U . s' I . " d A:_R . r' U . s' I
susierzinimą	s U . s' I . " E_F r' . z' I . n' I . m A:
susiformavo	s U . s' I . f O r . " m A:_R . v o:
susiformuoja	s U . s' I . f O r . " m U_F O . j a
susikaupti	s U . s' I . " k a U_R p' . t' I
susimeistravo	s U . s' I . m' E I . " s t r A:_R . v o:
susimąstyti	s U . s' I . m A: . " s' t' i:_F . t' I
susipažino	s U . s' I . p a . " Z' I . n o:
susirinkusieji	s U . s' I . " r' I n_R . k U . s' I e . j I
susituokę	s U . s' I . " t U O_R . k' {:
suspėti	s U . " s' p' e:_F . t' I	s U . s' p' e: . " t' I
sustojo	s U . " s t o:_F . j o:
susėdę	s U . " s' e:_F . d' {:
sutarties	s U . t a r' . " t' I e_R s
sutartis	s U . t a r' . " t' I s	" s U . t a r' . t' I s
suteikia	" s U . t' E I . k' a
sutikti	s U . t' I k . " t' I	s U . " t' I k . t' I
sutiktų	s U . t' I k . " t u:_R	s U . " t' I k . t u:
sutuoktinių	s U . t U O k . " t' I . n' u:
suvaidino	s U . v a I . " d' I . n o:
suvaldyti	s U . v a l' . " d' i:_F . t' I
suvienyti	s U . " v' I e_R . n' i: . t' I
sužadina	s U . " Z A:_R . d' I . n a
svajoja	s v a . " j o:_F . j a
svarbaus	s v a r . " b a U_R s
svarbesne	s v a r' . b' E . " s' n' E
svarbiausios	s v a r' . " b' a_F U . s' o: s
svarbą	" s v a r_R . b A:
svarbūs	" s v a r_R . b u: s
sveikatos	s' v' E I . " k A:_R . t o: s
sveikatą	s' v' E I . " k A:_R . t A:
sveikiems	s' v' E I . " k' I_F e m s
sveikino	" s' v' E_F I . k' I . n o:
svetainės	s' v' E . " t a I_R . n' e: s
svečiai	s' v' E . " tS' a I_R
sąžiningai	s A: . Z' I . " n' I_F n . g a I
sėdint	" s' e:_F . d' I n t
sėkmę	" s' e:_R k . m' {:
sūnus	s u: . " n U s	" s u:_F . n U s
ta	" t a
tad	" t a d
tai	" t a_F I	" t a I_R
taip	" t a I_R p
tais	" t a I_R s
taisyklingai	t a I . s' i: . " k l' I_F n . g a I
talpinamas	t a l' . " p' I . n a . m a s
tam	" t a_F m	" t a m_R
tampa	" t a m_R . p a
tampri	t a m' . " p' r' I
tarnautojų	t a r . " n a_F U . t o: . j u:
tarp	" t a r_R p
tarpu	" t a_F r . p U
tarpusavyje	t a r . " p U . s a . v' i: . j E
taryba	t a . " r' i:_F . b a
tarėsi	" t A:_R . r' e: . s' I
tau	" t a_F U
taupyti	t a U . " p' i:_F . t' I
taurės	" t a U_R . r' e: s	t a U . " r' e:_R s
taurę	" t a U_R . r' {:
tačiau	t a . " tS' a U_R
teatras	t' E . " A:_R . t r a s
teatre	t' E . a . " t' r' E	t' E . " A:_R . t' r' E
tebeauga	t' E . b' E . " a_F U . g a
tebegalioja	t' E . b' E . g a . " l' o:_F . j a
technologijos	t' E x . n O . " 5 O . g' I . j o: s
teigia	" t' E I_R . g' a
teigiamas	" t' E I_R . g' a . m a s
teikimu	t' E I . k' I . " m U
teisėjai	t' E I . " s' e:_F . j a I
teisėjų	t' E I . " s' e:_F . j u:
teisėsaugininkų	t' E I . " s' e:_F . s a U . g' I . n' I n . k u:
teko	" t' {:_R . k o:
telefonai	t' E . l' E . " f O . n a I	t' E . " l' E . f O . n a I
telefono	t' E . l' E . " f O . n o:	t' E . " l' E . f O . n o:
telefoną	t' E . l' E . " f O . n A:	t' E . " l' E . f O . n A:
televizijos	t' E . l' E . " v' I . z' I . j o: s
televizinius	t' E . l' E . " v' I . z' I . n' U s
telkinių	t' E l' . k' I . " n' u:_R
telkšo	" t' E 5_R k . S o:
terminų	" t' E r'_R . m' I . n u:
tiek	" t' I_F e k
tiesioginę	t' I e . " s' o:_F . g' I . n' {:
tik	" t' I k
tikrai	t' I . " k r a I_R	" t' I . k r a I
tikrinimo	" t' I . k r' I . n' I . m o:
tikrinti	" t' I . k r' I n' . t' I
tikslas	" t' I k . s 5 a s
tikslus	t' I k . " s 5 U s
tilto	" t' I_F 5 . t o:
tinka	" t' I n_R . k a
tinkamos	t' I n . k a . " m o:_R s	" t' I n_R . k a . m o: s
tirti	t' I r' . " t' I	" t' I_F r' . t' I
tituluojamas	t' I . t U . " 5 U_F O . j a . m a s
to	" t o:_R
tobulėkime	t o: . b U . " l' e:_F . k' I . m' E
todėl	t o: . " d' e:_R 5
tokioje	t o: . k' o: . " j E
toks	" t o:_F k s
tokį	" t o:_F . k' i:
toli	t o: . " l' I	" t o:_R . l' I
tolimą	" t o:_F . l' I . m A:	t o: . " l' I . m A:
tolimų	t o: . l' I . " m u:_R
tornadas	t O r . " n A:_R . d a s
tortų	" t O_F r . t u:
tradiciniam	t r a . " d' I . ts' I . n' a m
tradiciškai	t r a . " d' I . ts' I . S k a I
trajektorija	t r a . j E k . " t O . r' I . j a
transporto	t r a n . " s p O_F r . t o:	" t r a_F n . s p O r . t o:
traukinius	" t r a_F U . k' I . n' U s
traukos	t r a U . " k o:_R s
treneri	" t' r' E . n' E . r' I
treti	t' r' E . " t' I
trečia	t' r' E . " tS' a
trečiadienis	t' r' E . " tS' A:_R . d' I e . n' I s
trečiasis	t' r' E . " tS' a . s' I s
trečio	" t' r' {:_R . tS' o:
trečių	t' r' E . " tS' u:_R
trečiųjų	t' r' E . " tS' u:_R . j u:
trijų	t' r' I . " j u:_R	" t' r' I . j u:
trisdešimt	" t' r' I z' . d' E . S' I m t
trisdešimta	t' r' I z' . d' E . S' I m . " t a
trisdešimtoji	t' r' I . z' d' E . S' I m . " t o:_F . j I
trisdešimtų	t' r' I . z' d' E . S' I m . " t u:_R
triukšmu	t' r' U k . " S m U
trolį	" t r O . l' i:
trylika	" t' r' i:_F . l' I . k a
trylikta	" t' r' i:_F . l' I k . t a
tryliktą	" t' r' i:_F . l' I k . t A:
trys	" t' r' i:_R s
trūkumas	" t r u:_F . k U . m a s
tu	" t U
tuo	" t U O_R
turi	" t U . r' I	t U . " r' I
turime	" t U . r' I . m' E
turintys	" t U . r' I n' . t' i: s
turinčiais	" t U . r' I n' . tS' a I s
turnyrą	t U r' . " n' i:_R . r A:
turtuolių	t U r . " t U O_R . l' u:
turėjo	t U . " r' e:_F . j o:
turės	t U . " r' e:_R s
turėti	t U . " r' e:_F . t' I
turėtų	t U . " r' e:_F . t u:
tvarka	t v a r . " k a	" t v a r_R . k a
tvarką	" t v a r_R . k A:
tyliai	" t' i:_R . l' a I
tyrimai	t' i: . " r' I . m a I	" t' i:_F . r' I . m a I
tyrimo	t' i: . " r' I . m o:	" t' i:_F . r' I . m o:
tyrimus	t' i: . r' I . " m U s
tyrė	" t' i:_F . r' e:	" t' i:_R . r' e:	t' i: . " r' e:_R
tą	" t A:_R
tėkmės	t' e: k . " m' e:_R s	" t' e:_R k . m' e: s
tėvai	t' e: . " v a I_R
tėvų	t' e: . " v u:_R
tūkstantieji	t u: k . s t a n' . " t' I_F e . j I
tūkstantis	" t u:_F k . s t a n' . t' I s
tūkstančiai	" t u:_F k . s t a n' . tS' a I
tūkstančių	" t u:_F k . s t a n' . tS' u:
ugdymo	" U g . d' i: . m o:
unikalia	U . n' I . k a . " l' a
unikalų	U . n' I . " k A:_R . 5 u:
uostas	" U_F O . s t a s	" U O_R . s t a s
uoste	" U_F O s' . t' E
upelių	U . " p' {:_R . l' u:
upių	" U . p' u:
urmas	" U_F r . m a s
už	" U Z
užaugo	U Z . " a_F U . g o:
užbaigimą	U Z . b a I . " g' I . m A:
užfiksavo	U Z' . f' I k . " s A:_R . v o:
užfiksuoti	U Z' . f' I k . " s U_F O . t' I
užima	" U Z' . I . m a
užkimimas	U S' . k' I . " m' I . m a s
užkliuvo	U S' . " k l' U . v o:
užlieja	U Z' . " l' I_F e . j a
užmesti	U Z' . " m' E . s' t' I	U Z' . m' E . " s' t' I
užmigusį	U Z' . " m' I . g U . s' i:
užrašuose	U Z . r a . S U O . " s' E
užsieniečiai	U . s' I e . " n' I e_R . tS' a I	U S' . s' I e . " n' I e_R . tS' a I
užsieniečius	U . s' I e . n' I e . " tS' U s	U S' . s' I e . n' I e . " tS' U s	U . s' I e . " n' I e_R . tS' U s	U S' . s' I e . " n' I e_R . tS' U s
užsienio	" U . s' I e . n' o:
užsiima	U . " s' I . I . m a
užsitarnavo	U . s' I . t a r . " n A:_R . v o:	U S' . s' I . t a r . " n A:_R . v o:
užsitęsusios	U . s' I . " t' {:_R . s U . s' o: s	U S' . s' I . " t' {:_R . s U . s' o: s
užvakar	" U Z . v A: . k a r
vabzdžiai	" v a b' . Z' dZ' a I
vadinama	v a . " d' I . n a . m a
vadinamas	v a . " d' I . n a . m a s
vadinami	v a . " d' I . n a . m' I
vadovas	v a . " d o:_R . v a s
vadove	v a . " d o:_R . v' E
vadybos	v a . " d' i:_F . b o: s
vagį	" v A:_R . g' i:
vaidina	v a I . " d' I . n a
vaidinimas	v a I . " d' I . n' I . m a s
vaidmens	v a I d' . " m' E n_R s
vaikai	v a I . " k a I_R
vaikaičius	v a I . " k a_F I . tS' U s
vaikas	" v a I_R . k a s
vaike	v a I . " k' E
vaikinas	v a I . " k' I . n a s
vaikui	" v a I_R . k U i
vaikus	v a I . " k U s
vaikystė	v a I . " k' i:_R . s' t' e:
vaikščioja	" v a_F I k . S' tS' o: . j a
vaikščiojo	" v a_F I k . S' tS' o: . j o:
vaikų	" v a I_R . k u:
vairas	" v a I_R . r a s
vairuotojus	v a I . " r U_F O . t o: . j U s
vairuotojų	v a I . " r U_F O . t o: . j u:
vaisiais	" v a I_R . s' a I s
vaisius	" v a I_R . s' U s	v a I . " s' U s
vaismedžiai	" v a I_R . s' m' E . dZ' a I
vaizdai	v a I . " z d a I_R
vaizdingais	v a I . " z' d' I_F n . g a I s
vaizdinius	" v a I_R . z' d' I . n' U s
vaizdo	" v a I_R . z d o:
vaizduoklis	v a I . " z d U O_R . k l' I s
vaizduotę	v a I . " z d U O_R . t' {:
vakar	" v A:_R . k a r
vakare	" v A:_R . k a . r' E	v a . k a . " r' E
vakaro	" v A:_R . k a . r o:
vakaruose	v a . k a . r U O . " s' E
valanda	v a . 5 a n . " d a	" v A:_R . 5 a n . d a
valandas	" v A:_R . 5 a n . d a s
valandos	" v A:_R . 5 a n . d o: s	v a . 5 a n . " d o:_R s
valandą	" v A:_R . 5 a n . d A:
valandų	v a . 5 a n . " d u:_R
valdančiaisiais	" v a 5_R . d a n' . tS' a I . s' a I s
valdove	v a 5 . d o: . " v' E	v a 5 . " d o:_R . v' E
valdė	" v a l'_R . d' e:
valdžia	v a l' . " dZ' a
valdžios	" v a l'_R . dZ' o: s	v a l' . " dZ' o:_R s
valdžią	" v a l'_R . dZ' A:
valgio	" v a l'_R . g' o:
valgomajame	" v a_F 5 . g o: . m a . j a . m' E
valgyti	" v a_F l' . g' i: . t' I
valkata	" v a_F l' . k a . t a
valstija	v a l' . s' t' I . " j a	v a l' . " s' t' I . j a
valstybė	v a l' . " s' t' i:_F . b' e:
valstybės	v a l' . " s' t' i:_F . b' e: s
vandeniu	" v a_F n' . d' E . n' U	v a n' . d' E . " n' U	v a n' . " d' {:_R . n' U
vandens	v a n' . " d' E n_R s
vandenyno	v a n' . d' E . " n' i:_F . n o:
vandenyną	v a n' . d' E . " n' i:_F . n A:
vandenys	" v a_F n' . d' E . n' i: s
vardas	" v a r_R . d a s
vardą	" v a r_R . d A:
varguoli	v a r . " g U O_R . l' I
vargšų	" v a r_R k . S u:
varnos	" v a_F r . n o: s
vartojami	v a r . " t o:_F . j a . m' I
vartojimas	v a r . " t o:_F . j I . m a s
vartojimui	v a r . " t o:_F . j I . m U i
varžančius	" v a r_R . Z a n' . tS' U s
varžovus	v a r . Z o: . " v U s
varžybos	v a r' . " Z' i:_F . b o: s
varžybų	v a r' . " Z' i:_F . b u:
varžytis	v a r' . " Z' i:_F . t' I s
vasario	v a . " s A:_R . r' o:
vasaros	" v A:_R . s a . r o: s
vasarą	" v A:_R . s a . r A:
veidas	" v' E_F I . d a s
veiksnys	v' E I k . " s' n' i:_R s
veikti	" v' E I_R k . t' I	v' E I k . " t' I
veltėdi	v' E l' . " t' e:_R . d' I
verslininkams	" v' E r'_R . s' l' I . n' I n . k a m s
verslininkų	" v' E r'_R . s' l' I . n' I n . k u:
verslo	" v' E r_R . s 5 o:
verslą	" v' E r'_R . s 5 A:
vertinimo	" v' E_F r' . t' I . n' I . m o:
vertybe	v' E r' . " t' i:_F . b' E
vežti	" v' E . S' t' I	v' E . " S' t' I
vidurio	" v' I . d U . r' o:
viena	" v' I_F e . n a	v' I e . " n a
vienas	" v' I_F e . n a s	v' I e . " n a s
vienetais	" v' I_F e . n' E . t a I s
vienintelis	v' I e . " n' I n'_R . t' E . l' I s
vienodu	v' I e . " n o:_F . d U
vienodą	v' I e . " n o:_F . d A:
vienuolika	v' I e . " n U_F O . l' I . k a
vienuolikta	v' I e . " n U_F O . l' I k . t a
vienuoliktas	v' I e . " n U_F O . l' I k . t a s
vienuolikto	v' I e . " n U_F O . l' I k . t o:
vienuoliktą	v' I e . " n U_F O . l' I k . t A:
vienuoliktų	v' I e . " n U_F O . l' I k . t u:
vienuoliktųjų	v' I e . " n U_F O . l' I k . t u: . j u:
vieną	" v' I_F e . n A:
vienų	v' I e . " n u:_R
vieta	v' I e . " t a
vietos	" v' I e_R . t o: s
vietą	" v' I e_R . t A:
viešbutyje	" v' I e_R . Z b U . t' i: . j E
viešbučių	" v' I e_R . Z b U . tS' u:
viešėjo	v' I e . " S' e:_F . j o:
viešės	v' I e . " S' e:_R s
vilioja	v' I . " l' o:_F . j a
vilkinčių	" v' I l'_R . k' I n' . tS' u:
virtuvėje	v' I r . " t U . v' e: . j E
viršininke	" v' I r'_R . S' I . n' I n' . k' E
viršuje	v' I r . S U . " j E
vis	" v' I s
visada	v' I . s a . " d a
visai	v' I . " s a_F I
visame	v' I . s a . " m' E
visapusiškai	v' I . s a . " p U . s' I . S k a I
visiems	v' I . " s' I_F e m s
visiškai	" v' I . s' I . S k a I
viską	" v' I . s k A:
visuomenės	v' I . " s U_F O . m' E . n' e: s	v' I . s U O . m' E . " n' e:_R s
visuomenę	v' I . " s U_F O . m' E . n' {:
visuomet	v' I . s U O . " m' E t
visus	v' I . " s U s
visą	" v' I . s A:
visų	v' I . " s u:_R
vizitinių	v' I . " z' I . t' I . n' u:
vištos	" v' I . S t o: s
vyks	" v' i:_R k s
vyksta	" v' i:_R k . s t a
vynai	" v' i:_R . n a I	v' i: . " n a I_R
vyrai	" v' i:_F . r a I
vyras	" v' i:_F . r a s
vyresni	v' i: . r' E . " s' n' I	v' i: . " r' E . s' n' I
vyriausybė	v' i: . r' a U . " s' i:_F . b' e:
vyriausybę	v' i: . r' a U . " s' i:_F . b' {:
vyriškumo	v' i: . r' I . " S k U . m o:
vyriškį	v' i: . " r' I . S' k' i:
vėjas	" v' e:_F . j a s
vėjo	" v' e:_F . j o:
vėjuotas	v' e: . " j U_F O . t a s
vėl	" v' e:_R 5
vėliau	v' e: . " l' a U_R
vėžio	" v' e:_F . Z' o:
ypatinga	i: . p a . " t' I_F n . g a
ypatingai	i: . p a . " t' I_F n . g a I
ypač	" i:_F . p a tS
yra	i: . " r a	" i:_R . r a
zonoje	" z O . n o: . j E
Čapskis	" tS A:_R p' . s' k' I s
Čepas	" tS' {:_R . p a s
Černiaus	" tS' E r'_R . n' a U s
Česlovas	" tS' E . s 5 O . v a s
Čili	" tS' I . l' I
Čiulada	tS' U . 5 a . " d a
Čiurlionio	tS' U r' . " l' o:_F . n' o:
čempionato	tS' E m' . p' I . j O . " n A:_R . t o:
čia	" tS' a
ėda	" e:_F . d a
ėmiau	e: . " m' a U_R
į	" i:_R
įdomaus	i: . d o: . " m a U_R s
įdomiomis	i: . d o: . m' o: . " m' I s
įdomios	i: . " d o:_R . m' o: s	i: . d o: . " m' o:_R s
įeina	i: . " E I_R . n a
įeiti	i: . " E I_R . t' I
įgimtas	" i:_F . g' I m . t a s
įgudę	i: . " g U . d' {:
įgytas	i: . " g' i:_F . t a s
įgyvendino	i: . g' i: . " v' E_F n' . d' I . n o:
įkvėpė	" i:_R k . v' e: . p' e:
įkyrūs	i: . " k' i:_R . r u: s
įmonių	" i:_F . m o: . n' u:
įmonė	" i:_F . m o: . n' e:
įmonės	" i:_F . m o: . n' e: s
įmonėse	" i:_F . m o: . n' e: . s' E
įrankiai	" i:_F . r a n' . k' a I
įrankis	" i:_F . r a n' . k' I s
įrašas	" i:_F . r a . S a s
įrašytas	i: . r a . " S' i:_F . t a s
įrašų	" i:_F . r a . S u:
įrengti	i: . " r' E n'_R k . t' I	i: . r' E n' k . " t' I
įrengtos	i: . r' E n k . " t o:_R s	" i:_R . r' E n k . t o: s
įrodymų	i: . " r o:_F . d' i: . m u:
įrodyti	i: . " r o:_F . d' i: . t' I
įsiklausyti	i: . s' I . k 5 a U . " s' i:_F . t' I
įsikūręs	i: . s' I . " k u:_F . r' {: s
įskilo	i: . " s' k' I . 5 o:
įspėja	i: . " s' p' e:_F . j a
įspūdis	" i:_F . s p u: . d' I s
įtarimų	i: . t a . " r' I . m u:
įtikinama	i: . " t' I . k' I . n a . m a
įvairaus	i: . v a I . " r a U_R s
įvairiausių	i: . v a I . " r' a_F U . s' u:
įvairių	i: . v a I . " r' u:_R
įvedimo	i: . v' E . " d' I . m o:
įvertinimų	i: . " v' E_F r' . t' I . n' I . m u:
įvestų	i: . " v' E . s t u:	i: . v' E . " s t u:_R
įvykio	" i:_F . v' i: . k' o:
įvykį	" i:_F . v' i: . k' i:
įžymiu	i: . Z' i: . " m' U
Šakiai	S a . " k' a I_R
Šarlotė	S a r . " 5 O . t' e:
Šiaulių	S' a U . " l' u:_R
Šiaurės	" S' a_F U . r' e: s
Šilainiai	S' I . " 5 a I_R . n' a I
Širvaitis	S' I r . " v a_F I . t' I s
Šiškienė	S' I . " S' k' I_F e . n' e:
Šiūkšta	S' u: k . " S t a	" S' u:_R k . S t a
Šokienė	S o: . " k' I_F e . n' e:
šakai	" S A:_R . k a I
šaknimis	S a k . n' I . " m' I s
šakų	S a . " k u:_R
šalia	S a . " l' a
šalies	S a . " l' I e_R s
šaligatvio	S a . " l' I . g a t' . v' o:
šalims	S a . " l' I m_R s
šalis	S a . " l' I s
šalių	S a . " l' u:_R
šalmas	" S a 5_R . m a s
šaltiniai	S a l' . " t' I . n' a I
šaltiniais	S a l' . " t' I . n' a I s
šaltinių	S a l' . " t' I . n' u:
šalyje	S a . l' i: . " j E
šalys	" S A:_R . l' i: s
šalyse	S a . l' i: . " s' E	S a . " l' i:_F . s' E
šedešimt	S' E . " d' {:_R . S' I m t
šefe	" S' E . f' E
šeimininkė	S' E I . m' I . " n' I n'_R . k' e:
šeimos	" S' E I_R . m o: s	S' E I . " m o:_R s
šešerius	" S' {:_R . S' E . r' U s
šešerių	S' E . S' E . " r' u:_R
šeši	S' E . " S' I
šešiasdešimt	" S' {:_R . S' a z' . d' {: . S' I m t	S' {: . S' a z' . " d' {:_R . S' I m t
šešimt	" S' {:_R . S' I m t
šešiolika	S' E . " S' o:_F . l' I . k a
šešiolikta	S' E . " S' o:_F . l' I k . t a
šešioliktą	S' E . " S' o:_F . l' I k . t A:
šešios	" S' {:_R . S' o: s
šešių	S' E . " S' u:_R
šešta	S' E . " S t a
šeštadienio	S' E . " S t A:_R . d' I e . n' o:
šeštadienį	S' E . " S t A:_R . d' I e . n' i:
šešti	S' E . " S' t' I
šešto	" S' {:_R . S t o:
šeštoji	S' E . " S t o:_F . j I
šeštų	S' E . " S t u:_R
šeštųjų	S' E . " S t u:_R . j u:
ši	" S' I
šiai	" S' a_F I
šiais	" S' a I_R s
šiandien	" S' a n'_R . d' I e n
šiaurinės	S' a U . " r' I . n' e: s
šiaurės	" S' a_F U . r' e: s
šie	" S' I e_R
šiemet	" S' I e_R . m' E t
šieną	" S' I e_R . n A:
šiltesnės	S' I l' . " t' E . s' n' e: s	S' I l' . t' E . " s' n' e:_R s
šiluma	S' I . 5 U . " m a	" S' I . 5 U . m a
šimtai	S' I m . " t a I_R
šimtas	" S' I m_R . t a s
šio	" S' o:_R
šios	" S' o:_R s
širdimi	S' I r' . d' I . " m' I
šis	" S' I s
šitie	" S' I . t' I e
šiuolaikinės	S' U O . 5 a I . " k' I . n' e: s
šiureno	S' U . " r' {:_R . n o:
šiurkštus	S' U r k . " S t U s
šią	" S' A:_R
škvalai	" S k v A:_R . 5 a I
šlubuoja	S 5 U . " b U_F O . j a
šokių	" S o:_R . k' u:
šonų	" S o:_F . n u:
šunų	S U . " n u:_R
švedai	" S' v' E . d a I
šveicarai	S' v' E I . " ts A:_R . r a I
šventė	" S' v' E n'_R . t' e:
šventės	" S' v' E n'_R . t' e: s
šventųjų	S' v' E n . " t u:_R . j u:
švenčia	" S' v' E n'_R . tS' a
šviesos	S' v' I e . " s o:_R s	" S' v' I e_R . s o: s
šviesybe	S' v' I e . " s' i:_F . b' E
švietimo	S' v' I e . " t' I . m o:
šylant	" S' i:_R . 5 a n t
šį	" S' i:_R
Ūkio	" u:_F . k' o:
ūglius	u: . " g l' U s
ūkį	" u:_F . k' i:
Žaliakalnis	Z a . " l' A:_R . k a l' . n' I s
Žemaitkiemis	Z' E . " m a I_R t' . k' I e . m' I s
Žemės	" Z' {:_R . m' e: s
Žemę	" Z' {:_R . m' {:
Žiežmariai	Z' I e . " Z m A:_R . r' a I
Žilinskienė	Z' I . " l' I_F n' . s' k' I e . n' e:
Žolinės	Z o: . " l' I . n' e: s	" Z o:_R . l' I . n' e: s
Žydrūnas	Z' i: . " d r u:_F . n a s
Žygaičiai	Z' i: . " g a_F I . tS' a I
žadami	Z a . d a . " m' I
žadino	" Z A:_R . d' I . n o:
žaibiškai	" Z a I_R . b' I . S k a I
žaibus	Z a I . " b U s
žaidėjai	Z a I . " d' e:_F . j a I
žaidėjams	Z a I . " d' e:_F . j a m s
žaizdro	" Z a I_R z d . r o:
žaliausių	Z a . " l' a_F U . s' u:
žalius	Z a . " l' U s
žaliąją	" Z A:_R . l' A: . j A:
žalos	Z a . " 5 o:_R s	" Z A:_R . 5 o: s
žavi	Z a . " v' I
žavingoji	Z a . " v' I_F n . g o: . j I
žemėlapį	Z' E . " m' e:_F . 5 a . p' i:
žemės	" Z' {:_R . m' e: s	Z' E . " m' e:_F s
žemę	" Z' {:_R . m' {:
ženklą	" Z' E_F n . k 5 A:
žieve	Z' I e . " v' E	" Z' I e_R . v' E
žinias	Z' I . " n' a s
žiniasklaidą	Z' I . " n' A:_R . s k 5 a I . d A:
žinomas	" Z' I . n o: . m a s
žiūrovams	Z' u: . " r o:_R . v a m s
žiūrėti	Z' u: . " r' e:_F . t' I
žmogau	Z m o: . " g a U_R
žmogaus	Z m o: . " g a U_R s
žmogus	Z m o: . " g U s
žmonių	Z m o: . " n' u:_R
žmonėms	Z m o: . " n' e:_F m s
žmonės	" Z m o:_F . n' e: s
žurnalistas	Z U r . n a . " l' I . s t a s
žuvininkystės	Z U . v' I . n' I n' . " k' i:_F . s' t' e: s
žuvo	" Z U . v o:
žvalgybos	Z v a l' . " g' i:_F . b o: s
žvejybos	Z' v' E . " j i:_F . b o: s
žvyras	" Z' v' i:_R . r a s
žygiavo	Z' i: . " g' A:_R . v o:
žymiai	" Z' i:_R . m' a I
žymiausi	Z' i: . " m' a_F U . s' I
žymiausias	Z' i: . " m' a_F U . s' a s
